Grupo; Processo; Inst. Chegada; Tempo de Servi√ßo; Inst. Atendimento; Tempo Perm. Fila 
Grupo 1 
1; 1; 6; 5; 8; 2 
1; 2; 9; 5; 13; 4 
1; 3; 12; 5; 18; 6 
1; 4; 15; 5; 23; 8 
1; 5; 18; 5; 28; 10 
1; 6; 21; 5; 33; 12 
1; 7; 24; 5; 38; 14 
1; 8; 27; 5; 58; 31 
1; 9; 30; 5; 63; 33 
1; 10; 33; 5; 68; 35 
1; 11; 36; 5; 73; 37 
1; 12; 39; 5; 78; 39 
1; 13; 42; 5; 83; 41 
1; 14; 45; 5; 88; 43 
1; 15; 48; 5; 93; 45 
1; 16; 51; 5; 98; 47 
1; 17; 54; 5; 103; 49 
1; 18; 57; 5; 108; 51 
1; 19; 60; 5; 113; 53 
1; 20; 63; 5; 118; 55 
1; 21; 66; 5; 123; 57 
1; 22; 69; 5; 128; 59 
1; 23; 72; 5; 133; 61 
1; 24; 75; 5; 138; 63 
1; 25; 78; 5; 143; 65 
1; 26; 81; 5; 148; 67 
1; 27; 84; 5; 153; 69 
1; 28; 87; 5; 158; 71 
1; 29; 90; 5; 163; 73 
1; 30; 93; 5; 168; 75 
1; 31; 96; 5; 173; 77 
1; 32; 99; 5; 178; 79 
1; 33; 102; 5; 183; 81 
1; 34; 105; 5; 188; 83 
1; 35; 108; 5; 193; 85 
1; 36; 111; 5; 198; 87 
1; 37; 114; 5; 203; 89 
1; 38; 117; 5; 208; 91 
1; 39; 120; 5; 213; 93 
1; 40; 123; 5; 218; 95 
1; 41; 126; 5; 223; 97 
1; 42; 129; 5; 228; 99 
1; 43; 132; 5; 233; 101 
1; 44; 135; 5; 238; 103 
1; 45; 138; 5; 243; 105 
1; 46; 141; 5; 248; 107 
1; 47; 144; 5; 253; 109 
1; 48; 147; 5; 258; 111 
1; 49; 150; 5; 263; 113 
1; 50; 153; 5; 268; 115 
1; 51; 156; 5; 273; 117 
1; 52; 159; 5; 278; 119 
1; 53; 162; 5; 283; 121 
1; 54; 165; 5; 288; 123 
1; 55; 168; 5; 293; 125 
1; 56; 171; 5; 298; 127 
1; 57; 174; 5; 303; 129 
1; 58; 177; 5; 308; 131 
1; 59; 180; 5; 313; 133 
1; 60; 183; 5; 318; 135 
1; 61; 186; 5; 323; 137 
1; 62; 189; 5; 328; 139 
1; 63; 192; 5; 333; 141 
1; 64; 195; 5; 338; 143 
1; 65; 198; 5; 343; 145 
1; 66; 201; 5; 348; 147 
1; 67; 204; 5; 353; 149 
1; 68; 207; 5; 358; 151 
1; 69; 210; 5; 363; 153 
1; 70; 213; 5; 368; 155 
1; 71; 216; 5; 373; 157 
1; 72; 219; 5; 378; 159 
1; 73; 222; 5; 383; 161 
1; 74; 225; 5; 388; 163 
1; 75; 228; 5; 393; 165 
1; 76; 231; 5; 398; 167 
1; 77; 234; 5; 403; 169 
1; 78; 237; 5; 408; 171 
1; 79; 240; 5; 413; 173 
1; 80; 243; 5; 418; 175 
1; 81; 246; 5; 423; 177 
1; 82; 249; 5; 428; 179 
1; 83; 252; 5; 433; 181 
1; 84; 255; 5; 438; 183 
1; 85; 258; 5; 443; 185 
1; 86; 261; 5; 448; 187 
1; 87; 264; 5; 453; 189 
1; 88; 267; 5; 458; 191 
1; 89; 270; 5; 463; 193 
1; 90; 273; 5; 468; 195 
1; 91; 276; 5; 473; 197 
1; 92; 279; 5; 478; 199 
1; 93; 282; 5; 483; 201 
1; 94; 285; 5; 488; 203 
1; 95; 288; 5; 493; 205 
1; 96; 291; 5; 498; 207 
1; 97; 294; 5; 503; 209 
1; 98; 297; 5; 508; 211 
1; 99; 300; 5; 513; 213 
1; 100; 303; 5; 518; 215 
1; 101; 306; 5; 523; 217 
1; 102; 309; 5; 528; 219 
1; 103; 312; 5; 533; 221 
1; 104; 315; 5; 538; 223 
1; 105; 318; 5; 543; 225 
1; 106; 321; 5; 548; 227 
1; 107; 324; 5; 553; 229 
1; 108; 327; 5; 558; 231 
1; 109; 330; 5; 563; 233 
1; 110; 333; 5; 568; 235 
1; 111; 336; 5; 573; 237 
1; 112; 339; 5; 578; 239 
1; 113; 342; 5; 583; 241 
1; 114; 345; 5; 588; 243 
1; 115; 348; 5; 593; 245 
1; 116; 351; 5; 598; 247 
1; 117; 354; 5; 603; 249 
1; 118; 357; 5; 608; 251 
1; 119; 360; 5; 613; 253 
1; 120; 363; 5; 618; 255 
1; 121; 366; 5; 623; 257 
1; 122; 369; 5; 628; 259 
1; 123; 372; 5; 633; 261 
1; 124; 375; 5; 638; 263 
1; 125; 378; 5; 643; 265 
1; 126; 381; 5; 648; 267 
1; 127; 384; 5; 653; 269 
1; 128; 387; 5; 658; 271 
1; 129; 390; 5; 663; 273 
1; 130; 393; 5; 668; 275 
1; 131; 396; 5; 673; 277 
1; 132; 399; 5; 678; 279 
1; 133; 402; 5; 683; 281 
1; 134; 405; 5; 688; 283 
1; 135; 408; 5; 693; 285 
1; 136; 411; 5; 698; 287 
1; 137; 414; 5; 703; 289 
1; 138; 417; 5; 708; 291 
1; 139; 420; 5; 713; 293 
1; 140; 423; 5; 718; 295 
1; 141; 426; 5; 723; 297 
1; 142; 429; 5; 728; 299 
1; 143; 432; 5; 733; 301 
1; 144; 435; 5; 738; 303 
1; 145; 438; 5; 743; 305 
1; 146; 441; 5; 748; 307 
1; 147; 444; 5; 753; 309 
1; 148; 447; 5; 758; 311 
1; 149; 450; 5; 763; 313 
1; 150; 453; 5; 768; 315 
1; 151; 456; 5; 773; 317 
1; 152; 459; 5; 778; 319 
1; 153; 462; 5; 783; 321 
1; 154; 465; 5; 788; 323 
1; 155; 468; 5; 793; 325 
1; 156; 471; 5; 798; 327 
1; 157; 474; 5; 803; 329 
1; 158; 477; 5; 808; 331 
1; 159; 480; 5; 813; 333 
1; 160; 483; 5; 818; 335 
1; 161; 486; 5; 823; 337 
1; 162; 489; 5; 828; 339 
1; 163; 492; 5; 833; 341 
1; 164; 495; 5; 838; 343 
1; 165; 498; 5; 843; 345 
1; 166; 501; 5; 848; 347 
1; 167; 504; 5; 853; 349 
1; 168; 507; 5; 858; 351 
1; 169; 510; 5; 863; 353 
1; 170; 513; 5; 868; 355 
1; 171; 516; 5; 873; 357 
1; 172; 519; 5; 878; 359 
1; 173; 522; 5; 883; 361 
1; 174; 525; 5; 888; 363 
1; 175; 528; 5; 893; 365 
1; 176; 531; 5; 898; 367 
1; 177; 534; 5; 903; 369 
1; 178; 537; 5; 908; 371 
1; 179; 540; 5; 913; 373 
1; 180; 543; 5; 918; 375 
1; 181; 546; 5; 923; 377 
1; 182; 549; 5; 928; 379 
1; 183; 552; 5; 933; 381 
1; 184; 555; 5; 938; 383 
1; 185; 558; 5; 943; 385 
1; 186; 561; 5; 948; 387 
1; 187; 564; 5; 953; 389 
1; 188; 567; 5; 958; 391 
1; 189; 570; 5; 963; 393 
1; 190; 573; 5; 968; 395 
1; 191; 576; 5; 973; 397 
1; 192; 579; 5; 978; 399 
1; 193; 582; 5; 983; 401 
1; 194; 585; 5; 988; 403 
1; 195; 588; 5; 993; 405 
1; 196; 591; 5; 998; 407 
1; 197; 594; 5; 1003; 409 
1; 198; 597; 5; 1008; 411 
1; 199; 600; 5; 1013; 413 
1; 200; 603; 5; 1018; 415 
1; 201; 606; 5; 1023; 417 
1; 202; 609; 5; 1028; 419 
1; 203; 612; 5; 1033; 421 
1; 204; 615; 5; 1038; 423 
1; 205; 618; 5; 1043; 425 
1; 206; 621; 5; 1048; 427 
1; 207; 624; 5; 1053; 429 
1; 208; 627; 5; 1058; 431 
1; 209; 630; 5; 1063; 433 
1; 210; 633; 5; 1068; 435 
1; 211; 636; 5; 1073; 437 
1; 212; 639; 5; 1078; 439 
1; 213; 642; 5; 1083; 441 
1; 214; 645; 5; 1088; 443 
1; 215; 648; 5; 1093; 445 
1; 216; 651; 5; 1098; 447 
1; 217; 654; 5; 1103; 449 
1; 218; 657; 5; 1108; 451 
1; 219; 660; 5; 1113; 453 
1; 220; 663; 5; 1118; 455 
1; 221; 666; 5; 1123; 457 
1; 222; 669; 5; 1128; 459 
1; 223; 672; 5; 1133; 461 
1; 224; 675; 5; 1138; 463 
1; 225; 678; 5; 1143; 465 
1; 226; 681; 5; 1148; 467 
1; 227; 684; 5; 1153; 469 
1; 228; 687; 5; 1158; 471 
1; 229; 690; 5; 1163; 473 
1; 230; 693; 5; 1168; 475 
1; 231; 696; 5; 1173; 477 
1; 232; 699; 5; 1178; 479 
1; 233; 702; 5; 1183; 481 
1; 234; 705; 5; 1188; 483 
1; 235; 708; 5; 1193; 485 
1; 236; 711; 5; 1198; 487 
1; 237; 714; 5; 1203; 489 
1; 238; 717; 5; 1208; 491 
1; 239; 720; 5; 1213; 493 
1; 240; 723; 5; 1218; 495 
1; 241; 726; 5; 1223; 497 
1; 242; 729; 5; 1228; 499 
1; 243; 732; 5; 1233; 501 
1; 244; 735; 5; 1238; 503 
1; 245; 738; 5; 1243; 505 
1; 246; 741; 5; 1248; 507 
1; 247; 744; 5; 1253; 509 
1; 248; 747; 5; 1258; 511 
1; 249; 750; 5; 1263; 513 
1; 250; 753; 5; 1268; 515 
1; 251; 756; 5; 1273; 517 
1; 252; 759; 5; 1278; 519 
1; 253; 762; 5; 1283; 521 
1; 254; 765; 5; 1288; 523 
1; 255; 768; 5; 1293; 525 
1; 256; 771; 5; 1298; 527 
1; 257; 774; 5; 1303; 529 
1; 258; 777; 5; 1308; 531 
1; 259; 780; 5; 1313; 533 
1; 260; 783; 5; 1318; 535 
1; 261; 786; 5; 1323; 537 
1; 262; 789; 5; 1328; 539 
1; 263; 792; 5; 1333; 541 
1; 264; 795; 5; 1338; 543 
1; 265; 798; 5; 1343; 545 
1; 266; 801; 5; 1348; 547 
1; 267; 804; 5; 1353; 549 
1; 268; 807; 5; 1358; 551 
1; 269; 810; 5; 1363; 553 
1; 270; 813; 5; 1368; 555 
1; 271; 816; 5; 1373; 557 
1; 272; 819; 5; 1378; 559 
1; 273; 822; 5; 1383; 561 
1; 274; 825; 5; 1388; 563 
1; 275; 828; 5; 1393; 565 
1; 276; 831; 5; 1398; 567 
1; 277; 834; 5; 1403; 569 
1; 278; 837; 5; 1408; 571 
1; 279; 840; 5; 1413; 573 
1; 280; 843; 5; 1418; 575 
1; 281; 846; 5; 1423; 577 
1; 282; 849; 5; 1428; 579 
1; 283; 852; 5; 1433; 581 
1; 284; 855; 5; 1438; 583 
1; 285; 858; 5; 1443; 585 
1; 286; 861; 5; 1448; 587 
1; 287; 864; 5; 1453; 589 
1; 288; 867; 5; 1458; 591 
1; 289; 870; 5; 1463; 593 
1; 290; 873; 5; 1468; 595 
1; 291; 876; 5; 1473; 597 
1; 292; 879; 5; 1478; 599 
1; 293; 882; 5; 1483; 601 
1; 294; 885; 5; 1488; 603 
1; 295; 888; 5; 1493; 605 
1; 296; 891; 5; 1498; 607 
1; 297; 894; 5; 1503; 609 
1; 298; 897; 5; 1508; 611 
1; 299; 900; 5; 1513; 613 
1; 300; 903; 5; 1518; 615 
1; 301; 906; 5; 1523; 617 
1; 302; 909; 5; 1528; 619 
1; 303; 912; 5; 1533; 621 
1; 304; 915; 5; 1538; 623 
1; 305; 918; 5; 1543; 625 
1; 306; 921; 5; 1548; 627 
1; 307; 924; 5; 1553; 629 
1; 308; 927; 5; 1558; 631 
1; 309; 930; 5; 1563; 633 
1; 310; 933; 5; 1568; 635 
1; 311; 936; 5; 1573; 637 
1; 312; 939; 5; 1578; 639 
1; 313; 942; 5; 1583; 641 
1; 314; 945; 5; 1588; 643 
1; 315; 948; 5; 1593; 645 
1; 316; 951; 5; 1598; 647 
1; 317; 954; 5; 1603; 649 
1; 318; 957; 5; 1608; 651 
1; 319; 960; 5; 1613; 653 
1; 320; 963; 5; 1618; 655 
1; 321; 966; 5; 1623; 657 
1; 322; 969; 5; 1628; 659 
1; 323; 972; 5; 1633; 661 
1; 324; 975; 5; 1638; 663 
1; 325; 978; 5; 1643; 665 
1; 326; 981; 5; 1648; 667 
1; 327; 984; 5; 1653; 669 
1; 328; 987; 5; 1658; 671 
1; 329; 990; 5; 1663; 673 
1; 330; 993; 5; 1668; 675 
1; 331; 996; 5; 1673; 677 
1; 332; 999; 5; 1678; 679 
1; 333; 1002; 5; 1683; 681 
1; 334; 1005; 5; 1688; 683 
1; 335; 1008; 5; 1693; 685 
1; 336; 1011; 5; 1698; 687 
1; 337; 1014; 5; 1703; 689 
1; 338; 1017; 5; 1708; 691 
1; 339; 1020; 5; 1713; 693 
1; 340; 1023; 5; 1718; 695 
1; 341; 1026; 5; 1723; 697 
1; 342; 1029; 5; 1728; 699 
1; 343; 1032; 5; 1733; 701 
1; 344; 1035; 5; 1738; 703 
1; 345; 1038; 5; 1743; 705 
1; 346; 1041; 5; 1748; 707 
1; 347; 1044; 5; 1753; 709 
1; 348; 1047; 5; 1758; 711 
1; 349; 1050; 5; 1763; 713 
1; 350; 1053; 5; 1768; 715 
1; 351; 1056; 5; 1773; 717 
1; 352; 1059; 5; 1778; 719 
1; 353; 1062; 5; 1783; 721 
1; 354; 1065; 5; 1788; 723 
1; 355; 1068; 5; 1793; 725 
1; 356; 1071; 5; 1798; 727 
1; 357; 1074; 5; 1803; 729 
1; 358; 1077; 5; 1808; 731 
1; 359; 1080; 5; 1813; 733 
1; 360; 1083; 5; 1818; 735 
1; 361; 1086; 5; 1823; 737 
1; 362; 1089; 5; 1828; 739 
1; 363; 1092; 5; 1833; 741 
1; 364; 1095; 5; 1838; 743 
1; 365; 1098; 5; 1843; 745 
1; 366; 1101; 5; 1848; 747 
1; 367; 1104; 5; 1853; 749 
1; 368; 1107; 5; 1858; 751 
1; 369; 1110; 5; 1863; 753 
1; 370; 1113; 5; 1868; 755 
1; 371; 1116; 5; 1873; 757 
1; 372; 1119; 5; 1878; 759 
1; 373; 1122; 5; 1883; 761 
1; 374; 1125; 5; 1888; 763 
1; 375; 1128; 5; 1893; 765 
1; 376; 1131; 5; 1898; 767 
1; 377; 1134; 5; 1903; 769 
1; 378; 1137; 5; 1908; 771 
1; 379; 1140; 5; 1913; 773 
1; 380; 1143; 5; 1918; 775 
1; 381; 1146; 5; 1923; 777 
1; 382; 1149; 5; 1928; 779 
1; 383; 1152; 5; 1933; 781 
1; 384; 1155; 5; 1938; 783 
1; 385; 1158; 5; 1943; 785 
1; 386; 1161; 5; 1948; 787 
1; 387; 1164; 5; 1953; 789 
1; 388; 1167; 5; 1958; 791 
1; 389; 1170; 5; 1963; 793 
1; 390; 1173; 5; 1968; 795 
1; 391; 1176; 5; 1973; 797 
1; 392; 1179; 5; 1978; 799 
1; 393; 1182; 5; 1983; 801 
1; 394; 1185; 5; 1988; 803 
1; 395; 1188; 5; 1993; 805 
1; 396; 1191; 5; 1998; 807 
1; 397; 1194; 5; 2003; 809 
1; 398; 1197; 5; 2008; 811 
1; 399; 1200; 5; 2013; 813 
1; 400; 1203; 5; 2018; 815 
1; 401; 1206; 5; 2023; 817 
1; 402; 1209; 5; 2028; 819 
1; 403; 1212; 5; 2033; 821 
1; 404; 1215; 5; 2038; 823 
1; 405; 1218; 5; 2043; 825 
1; 406; 1221; 5; 2048; 827 
1; 407; 1224; 5; 2053; 829 
1; 408; 1227; 5; 2058; 831 
1; 409; 1230; 5; 2063; 833 
1; 410; 1233; 5; 2068; 835 
1; 411; 1236; 5; 2073; 837 
1; 412; 1239; 5; 2078; 839 
1; 413; 1242; 5; 2083; 841 
1; 414; 1245; 5; 2088; 843 
1; 415; 1248; 5; 2093; 845 
1; 416; 1251; 5; 2098; 847 
1; 417; 1254; 5; 2103; 849 
1; 418; 1257; 5; 2108; 851 
1; 419; 1260; 5; 2113; 853 
1; 420; 1263; 5; 2118; 855 
1; 421; 1266; 5; 2123; 857 
1; 422; 1269; 5; 2128; 859 
1; 423; 1272; 5; 2133; 861 
1; 424; 1275; 5; 2138; 863 
1; 425; 1278; 5; 2143; 865 
1; 426; 1281; 5; 2148; 867 
1; 427; 1284; 5; 2153; 869 
1; 428; 1287; 5; 2158; 871 
1; 429; 1290; 5; 2163; 873 
1; 430; 1293; 5; 2168; 875 
1; 431; 1296; 5; 2173; 877 
1; 432; 1299; 5; 2178; 879 
1; 433; 1302; 5; 2183; 881 
1; 434; 1305; 5; 2188; 883 
1; 435; 1308; 5; 2193; 885 
1; 436; 1311; 5; 2198; 887 
1; 437; 1314; 5; 2203; 889 
1; 438; 1317; 5; 2208; 891 
1; 439; 1320; 5; 2213; 893 
1; 440; 1323; 5; 2218; 895 
1; 441; 1326; 5; 2223; 897 
1; 442; 1329; 5; 2228; 899 
1; 443; 1332; 5; 2233; 901 
1; 444; 1335; 5; 2238; 903 
1; 445; 1338; 5; 2243; 905 
1; 446; 1341; 5; 2248; 907 
1; 447; 1344; 5; 2253; 909 
1; 448; 1347; 5; 2258; 911 
1; 449; 1350; 5; 2263; 913 
1; 450; 1353; 5; 2268; 915 
1; 451; 1356; 5; 2273; 917 
1; 452; 1359; 5; 2278; 919 
1; 453; 1362; 5; 2283; 921 
1; 454; 1365; 5; 2288; 923 
1; 455; 1368; 5; 2293; 925 
1; 456; 1371; 5; 2298; 927 
1; 457; 1374; 5; 2303; 929 
1; 458; 1377; 5; 2308; 931 
1; 459; 1380; 5; 2313; 933 
1; 460; 1383; 5; 2318; 935 
1; 461; 1386; 5; 2323; 937 
1; 462; 1389; 5; 2328; 939 
1; 463; 1392; 5; 2333; 941 
1; 464; 1395; 5; 2338; 943 
1; 465; 1398; 5; 2343; 945 
1; 466; 1401; 5; 2348; 947 
1; 467; 1404; 5; 2353; 949 
1; 468; 1407; 5; 2358; 951 
1; 469; 1410; 5; 2363; 953 
1; 470; 1413; 5; 2368; 955 
1; 471; 1416; 5; 2373; 957 
1; 472; 1419; 5; 2378; 959 
1; 473; 1422; 5; 2383; 961 
1; 474; 1425; 5; 2388; 963 
1; 475; 1428; 5; 2393; 965 
1; 476; 1431; 5; 2398; 967 
1; 477; 1434; 5; 2403; 969 
1; 478; 1437; 5; 2408; 971 
1; 479; 1440; 5; 2413; 973 
1; 480; 1443; 5; 2418; 975 
1; 481; 1446; 5; 2423; 977 
1; 482; 1449; 5; 2428; 979 
1; 483; 1452; 5; 2433; 981 
1; 484; 1455; 5; 2438; 983 
1; 485; 1458; 5; 2443; 985 
1; 486; 1461; 5; 2448; 987 
1; 487; 1464; 5; 2453; 989 
1; 488; 1467; 5; 2458; 991 
1; 489; 1470; 5; 2463; 993 
1; 490; 1473; 5; 2468; 995 
1; 491; 1476; 5; 2473; 997 
1; 492; 1479; 5; 2478; 999 
1; 493; 1482; 5; 2483; 1001 
1; 494; 1485; 5; 2488; 1003 
1; 495; 1488; 5; 2493; 1005 
1; 496; 1491; 5; 2498; 1007 
1; 497; 1494; 5; 2503; 1009 
1; 498; 1497; 5; 2508; 1011 
1; 499; 1500; 5; 2513; 1013 
1; 500; 1503; 5; 2518; 1015 
1; 501; 1506; 5; 2523; 1017 
1; 502; 1509; 5; 2528; 1019 
1; 503; 1512; 5; 2533; 1021 
1; 504; 1515; 5; 2538; 1023 
1; 505; 1518; 5; 2543; 1025 
1; 506; 1521; 5; 2548; 1027 
1; 507; 1524; 5; 2553; 1029 
1; 508; 1527; 5; 2558; 1031 
1; 509; 1530; 5; 2563; 1033 
1; 510; 1533; 5; 2568; 1035 
1; 511; 1536; 5; 2573; 1037 
1; 512; 1539; 5; 2578; 1039 
1; 513; 1542; 5; 2583; 1041 
1; 514; 1545; 5; 2588; 1043 
1; 515; 1548; 5; 2593; 1045 
1; 516; 1551; 5; 2598; 1047 
1; 517; 1554; 5; 2603; 1049 
1; 518; 1557; 5; 2608; 1051 
1; 519; 1560; 5; 2613; 1053 
1; 520; 1563; 5; 2618; 1055 
1; 521; 1566; 5; 2623; 1057 
1; 522; 1569; 5; 2628; 1059 
1; 523; 1572; 5; 2633; 1061 
1; 524; 1575; 5; 2638; 1063 
1; 525; 1578; 5; 2643; 1065 
1; 526; 1581; 5; 2648; 1067 
1; 527; 1584; 5; 2653; 1069 
1; 528; 1587; 5; 2658; 1071 
1; 529; 1590; 5; 2663; 1073 
1; 530; 1593; 5; 2668; 1075 
1; 531; 1596; 5; 2673; 1077 
1; 532; 1599; 5; 2678; 1079 
1; 533; 1602; 5; 2683; 1081 
1; 534; 1605; 5; 2688; 1083 
1; 535; 1608; 5; 2693; 1085 
1; 536; 1611; 5; 2698; 1087 
1; 537; 1614; 5; 2703; 1089 
1; 538; 1617; 5; 2708; 1091 
1; 539; 1620; 5; 2713; 1093 
1; 540; 1623; 5; 2718; 1095 
1; 541; 1626; 5; 2723; 1097 
1; 542; 1629; 5; 2728; 1099 
1; 543; 1632; 5; 2733; 1101 
1; 544; 1635; 5; 2738; 1103 
1; 545; 1638; 5; 2743; 1105 
1; 546; 1641; 5; 2748; 1107 
1; 547; 1644; 5; 2753; 1109 
1; 548; 1647; 5; 2758; 1111 
1; 549; 1650; 5; 2763; 1113 
1; 550; 1653; 5; 2768; 1115 
1; 551; 1656; 5; 2773; 1117 
1; 552; 1659; 5; 2778; 1119 
1; 553; 1662; 5; 2783; 1121 
1; 554; 1665; 5; 2788; 1123 
1; 555; 1668; 5; 2793; 1125 
1; 556; 1671; 5; 2798; 1127 
1; 557; 1674; 5; 2803; 1129 
1; 558; 1677; 5; 2808; 1131 
1; 559; 1680; 5; 2813; 1133 
1; 560; 1683; 5; 2818; 1135 
1; 561; 1686; 5; 2823; 1137 
1; 562; 1689; 5; 2828; 1139 
1; 563; 1692; 5; 2833; 1141 
1; 564; 1695; 5; 2838; 1143 
1; 565; 1698; 5; 2843; 1145 
1; 566; 1701; 5; 2848; 1147 
1; 567; 1704; 5; 2853; 1149 
1; 568; 1707; 5; 2858; 1151 
1; 569; 1710; 5; 2863; 1153 
1; 570; 1713; 5; 2868; 1155 
1; 571; 1716; 5; 2873; 1157 
1; 572; 1719; 5; 2878; 1159 
1; 573; 1722; 5; 2883; 1161 
1; 574; 1725; 5; 2888; 1163 
1; 575; 1728; 5; 2893; 1165 
1; 576; 1731; 5; 2898; 1167 
1; 577; 1734; 5; 2903; 1169 
1; 578; 1737; 5; 2908; 1171 
1; 579; 1740; 5; 2913; 1173 
1; 580; 1743; 5; 2918; 1175 
1; 581; 1746; 5; 2923; 1177 
1; 582; 1749; 5; 2928; 1179 
1; 583; 1752; 5; 2933; 1181 
1; 584; 1755; 5; 2938; 1183 
1; 585; 1758; 5; 2943; 1185 
1; 586; 1761; 5; 2948; 1187 
1; 587; 1764; 5; 2953; 1189 
1; 588; 1767; 5; 2958; 1191 
1; 589; 1770; 5; 2963; 1193 
1; 590; 1773; 5; 2968; 1195 
1; 591; 1776; 5; 2973; 1197 
1; 592; 1779; 5; 2978; 1199 
1; 593; 1782; 5; 2983; 1201 
1; 594; 1785; 5; 2988; 1203 
1; 595; 1788; 5; 2993; 1205 
1; 596; 1791; 5; 2998; 1207 
1; 597; 1794; 5; 3003; 1209 
1; 598; 1797; 5; 3008; 1211 
1; 599; 1800; 5; 3013; 1213 
1; 600; 1803; 5; 3018; 1215 
1; 601; 1806; 5; 3023; 1217 
1; 602; 1809; 5; 3028; 1219 
1; 603; 1812; 5; 3033; 1221 
1; 604; 1815; 5; 3038; 1223 
1; 605; 1818; 5; 3043; 1225 
1; 606; 1821; 5; 3048; 1227 
1; 607; 1824; 5; 3053; 1229 
1; 608; 1827; 5; 3058; 1231 
1; 609; 1830; 5; 3063; 1233 
1; 610; 1833; 5; 3068; 1235 
1; 611; 1836; 5; 3073; 1237 
1; 612; 1839; 5; 3078; 1239 
1; 613; 1842; 5; 3083; 1241 
1; 614; 1845; 5; 3088; 1243 
1; 615; 1848; 5; 3093; 1245 
1; 616; 1851; 5; 3098; 1247 
1; 617; 1854; 5; 3103; 1249 
1; 618; 1857; 5; 3108; 1251 
1; 619; 1860; 5; 3113; 1253 
1; 620; 1863; 5; 3118; 1255 
1; 621; 1866; 5; 3123; 1257 
1; 622; 1869; 5; 3128; 1259 
1; 623; 1872; 5; 3133; 1261 
1; 624; 1875; 5; 3138; 1263 
1; 625; 1878; 5; 3143; 1265 
1; 626; 1881; 5; 3148; 1267 
1; 627; 1884; 5; 3153; 1269 
1; 628; 1887; 5; 3158; 1271 
1; 629; 1890; 5; 3163; 1273 
1; 630; 1893; 5; 3168; 1275 
1; 631; 1896; 5; 3173; 1277 
1; 632; 1899; 5; 3178; 1279 
1; 633; 1902; 5; 3183; 1281 
1; 634; 1905; 5; 3188; 1283 
1; 635; 1908; 5; 3193; 1285 
1; 636; 1911; 5; 3198; 1287 
1; 637; 1914; 5; 3203; 1289 
1; 638; 1917; 5; 3208; 1291 
1; 639; 1920; 5; 3213; 1293 
1; 640; 1923; 5; 3218; 1295 
1; 641; 1926; 5; 3223; 1297 
1; 642; 1929; 5; 3228; 1299 
1; 643; 1932; 5; 3233; 1301 
1; 644; 1935; 5; 3238; 1303 
1; 645; 1938; 5; 3243; 1305 
1; 646; 1941; 5; 3248; 1307 
1; 647; 1944; 5; 3253; 1309 
1; 648; 1947; 5; 3258; 1311 
1; 649; 1950; 5; 3263; 1313 
1; 650; 1953; 5; 3268; 1315 
1; 651; 1956; 5; 3273; 1317 
1; 652; 1959; 5; 3278; 1319 
1; 653; 1962; 5; 3283; 1321 
1; 654; 1965; 5; 3288; 1323 
1; 655; 1968; 5; 3293; 1325 
1; 656; 1971; 5; 3298; 1327 
1; 657; 1974; 5; 3303; 1329 
1; 658; 1977; 5; 3308; 1331 
1; 659; 1980; 5; 3313; 1333 
1; 660; 1983; 5; 3318; 1335 
1; 661; 1986; 5; 3323; 1337 
1; 662; 1989; 5; 3328; 1339 
1; 663; 1992; 5; 3333; 1341 
1; 664; 1995; 5; 3338; 1343 
1; 665; 1998; 5; 3343; 1345 
1; 666; 2001; 5; 3348; 1347 
1; 667; 2004; 5; 3353; 1349 
1; 668; 2007; 5; 3358; 1351 
1; 669; 2010; 5; 3363; 1353 
1; 670; 2013; 5; 3368; 1355 
1; 671; 2016; 5; 3373; 1357 
1; 672; 2019; 5; 3378; 1359 
1; 673; 2022; 5; 3383; 1361 
1; 674; 2025; 5; 3388; 1363 
1; 675; 2028; 5; 3393; 1365 
1; 676; 2031; 5; 3398; 1367 
1; 677; 2034; 5; 3403; 1369 
1; 678; 2037; 5; 3408; 1371 
1; 679; 2040; 5; 3413; 1373 
1; 680; 2043; 5; 3418; 1375 
1; 681; 2046; 5; 3423; 1377 
1; 682; 2049; 5; 3428; 1379 
1; 683; 2052; 5; 3433; 1381 
1; 684; 2055; 5; 3438; 1383 
1; 685; 2058; 5; 3443; 1385 
1; 686; 2061; 5; 3448; 1387 
1; 687; 2064; 5; 3453; 1389 
1; 688; 2067; 5; 3458; 1391 
1; 689; 2070; 5; 3463; 1393 
1; 690; 2073; 5; 3468; 1395 
1; 691; 2076; 5; 3473; 1397 
1; 692; 2079; 5; 3478; 1399 
1; 693; 2082; 5; 3483; 1401 
1; 694; 2085; 5; 3488; 1403 
1; 695; 2088; 5; 3493; 1405 
1; 696; 2091; 5; 3498; 1407 
1; 697; 2094; 5; 3503; 1409 
1; 698; 2097; 5; 3508; 1411 
1; 699; 2100; 5; 3513; 1413 
1; 700; 2103; 5; 3518; 1415 
1; 701; 2106; 5; 3523; 1417 
1; 702; 2109; 5; 3528; 1419 
1; 703; 2112; 5; 3533; 1421 
1; 704; 2115; 5; 3538; 1423 
1; 705; 2118; 5; 3543; 1425 
1; 706; 2121; 5; 3548; 1427 
1; 707; 2124; 5; 3553; 1429 
1; 708; 2127; 5; 3558; 1431 
1; 709; 2130; 5; 3563; 1433 
1; 710; 2133; 5; 3568; 1435 
1; 711; 2136; 5; 3573; 1437 
1; 712; 2139; 5; 3578; 1439 
1; 713; 2142; 5; 3583; 1441 
1; 714; 2145; 5; 3588; 1443 
1; 715; 2148; 5; 3593; 1445 
1; 716; 2151; 5; 3598; 1447 
1; 717; 2154; 5; 3603; 1449 
1; 718; 2157; 5; 3608; 1451 
1; 719; 2160; 5; 3613; 1453 
1; 720; 2163; 5; 3618; 1455 
1; 721; 2166; 5; 3623; 1457 
1; 722; 2169; 5; 3628; 1459 
1; 723; 2172; 5; 3633; 1461 
1; 724; 2175; 5; 3638; 1463 
1; 725; 2178; 5; 3643; 1465 
1; 726; 2181; 5; 3648; 1467 
1; 727; 2184; 5; 3653; 1469 
1; 728; 2187; 5; 3658; 1471 
1; 729; 2190; 5; 3663; 1473 
1; 730; 2193; 5; 3668; 1475 
1; 731; 2196; 5; 3673; 1477 
1; 732; 2199; 5; 3678; 1479 
1; 733; 2202; 5; 3683; 1481 
1; 734; 2205; 5; 3688; 1483 
1; 735; 2208; 5; 3693; 1485 
1; 736; 2211; 5; 3698; 1487 
1; 737; 2214; 5; 3703; 1489 
1; 738; 2217; 5; 3708; 1491 
1; 739; 2220; 5; 3713; 1493 
1; 740; 2223; 5; 3718; 1495 
1; 741; 2226; 5; 3723; 1497 
1; 742; 2229; 5; 3728; 1499 
1; 743; 2232; 5; 3733; 1501 
1; 744; 2235; 5; 3738; 1503 
1; 745; 2238; 5; 3743; 1505 
1; 746; 2241; 5; 3748; 1507 
1; 747; 2244; 5; 3753; 1509 
1; 748; 2247; 5; 3758; 1511 
1; 749; 2250; 5; 3763; 1513 
1; 750; 2253; 5; 3768; 1515 
1; 751; 2256; 5; 3773; 1517 
1; 752; 2259; 5; 3778; 1519 
1; 753; 2262; 5; 3783; 1521 
1; 754; 2265; 5; 3788; 1523 
1; 755; 2268; 5; 3793; 1525 
1; 756; 2271; 5; 3798; 1527 
1; 757; 2274; 5; 3803; 1529 
1; 758; 2277; 5; 3808; 1531 
1; 759; 2280; 5; 3813; 1533 
1; 760; 2283; 5; 3818; 1535 
1; 761; 2286; 5; 3823; 1537 
1; 762; 2289; 5; 3828; 1539 
1; 763; 2292; 5; 3833; 1541 
1; 764; 2295; 5; 3838; 1543 
1; 765; 2298; 5; 3843; 1545 
1; 766; 2301; 5; 3848; 1547 
1; 767; 2304; 5; 3853; 1549 
1; 768; 2307; 5; 3858; 1551 
1; 769; 2310; 5; 3863; 1553 
1; 770; 2313; 5; 3868; 1555 
1; 771; 2316; 5; 3873; 1557 
1; 772; 2319; 5; 3878; 1559 
1; 773; 2322; 5; 3883; 1561 
1; 774; 2325; 5; 3888; 1563 
1; 775; 2328; 5; 3893; 1565 
1; 776; 2331; 5; 3898; 1567 
1; 777; 2334; 5; 3903; 1569 
1; 778; 2337; 5; 3908; 1571 
1; 779; 2340; 5; 3913; 1573 
1; 780; 2343; 5; 3918; 1575 
1; 781; 2346; 5; 3923; 1577 
1; 782; 2349; 5; 3928; 1579 
1; 783; 2352; 5; 3933; 1581 
1; 784; 2355; 5; 3938; 1583 
1; 785; 2358; 5; 3943; 1585 
1; 786; 2361; 5; 3948; 1587 
1; 787; 2364; 5; 3953; 1589 
1; 788; 2367; 5; 3958; 1591 
1; 789; 2370; 5; 3963; 1593 
1; 790; 2373; 5; 3968; 1595 
1; 791; 2376; 5; 3973; 1597 
1; 792; 2379; 5; 3978; 1599 
1; 793; 2382; 5; 3983; 1601 
1; 794; 2385; 5; 3988; 1603 
1; 795; 2388; 5; 3993; 1605 
1; 796; 2391; 5; 3998; 1607 
1; 797; 2394; 5; 4003; 1609 
1; 798; 2397; 5; 4008; 1611 
1; 799; 2400; 5; 4013; 1613 
1; 800; 2403; 5; 4018; 1615 
1; 801; 2406; 5; 4023; 1617 
1; 802; 2409; 5; 4028; 1619 
1; 803; 2412; 5; 4033; 1621 
1; 804; 2415; 5; 4038; 1623 
1; 805; 2418; 5; 4043; 1625 
1; 806; 2421; 5; 4048; 1627 
1; 807; 2424; 5; 4053; 1629 
1; 808; 2427; 5; 4058; 1631 
1; 809; 2430; 5; 4063; 1633 
1; 810; 2433; 5; 4068; 1635 
1; 811; 2436; 5; 4073; 1637 
1; 812; 2439; 5; 4078; 1639 
1; 813; 2442; 5; 4083; 1641 
1; 814; 2445; 5; 4088; 1643 
1; 815; 2448; 5; 4093; 1645 
1; 816; 2451; 5; 4098; 1647 
1; 817; 2454; 5; 4103; 1649 
1; 818; 2457; 5; 4108; 1651 
1; 819; 2460; 5; 4113; 1653 
1; 820; 2463; 5; 4118; 1655 
1; 821; 2466; 5; 4123; 1657 
1; 822; 2469; 5; 4128; 1659 
1; 823; 2472; 5; 4133; 1661 
1; 824; 2475; 5; 4138; 1663 
1; 825; 2478; 5; 4143; 1665 
1; 826; 2481; 5; 4148; 1667 
1; 827; 2484; 5; 4153; 1669 
1; 828; 2487; 5; 4158; 1671 
1; 829; 2490; 5; 4163; 1673 
1; 830; 2493; 5; 4168; 1675 
1; 831; 2496; 5; 4173; 1677 
1; 832; 2499; 5; 4178; 1679 
1; 833; 2502; 5; 4183; 1681 
1; 834; 2505; 5; 4188; 1683 
1; 835; 2508; 5; 4193; 1685 
1; 836; 2511; 5; 4198; 1687 
1; 837; 2514; 5; 4203; 1689 
1; 838; 2517; 5; 4208; 1691 
1; 839; 2520; 5; 4213; 1693 
1; 840; 2523; 5; 4218; 1695 
1; 841; 2526; 5; 4223; 1697 
1; 842; 2529; 5; 4228; 1699 
1; 843; 2532; 5; 4233; 1701 
1; 844; 2535; 5; 4238; 1703 
1; 845; 2538; 5; 4243; 1705 
1; 846; 2541; 5; 4248; 1707 
1; 847; 2544; 5; 4253; 1709 
1; 848; 2547; 5; 4258; 1711 
1; 849; 2550; 5; 4263; 1713 
1; 850; 2553; 5; 4268; 1715 
1; 851; 2556; 5; 4273; 1717 
1; 852; 2559; 5; 4278; 1719 
1; 853; 2562; 5; 4283; 1721 
1; 854; 2565; 5; 4288; 1723 
1; 855; 2568; 5; 4293; 1725 
1; 856; 2571; 5; 4298; 1727 
1; 857; 2574; 5; 4303; 1729 
1; 858; 2577; 5; 4308; 1731 
1; 859; 2580; 5; 4313; 1733 
1; 860; 2583; 5; 4318; 1735 
1; 861; 2586; 5; 4323; 1737 
1; 862; 2589; 5; 4328; 1739 
1; 863; 2592; 5; 4333; 1741 
1; 864; 2595; 5; 4338; 1743 
1; 865; 2598; 5; 4343; 1745 
1; 866; 2601; 5; 4348; 1747 
1; 867; 2604; 5; 4353; 1749 
1; 868; 2607; 5; 4358; 1751 
1; 869; 2610; 5; 4363; 1753 
1; 870; 2613; 5; 4368; 1755 
1; 871; 2616; 5; 4373; 1757 
1; 872; 2619; 5; 4378; 1759 
1; 873; 2622; 5; 4383; 1761 
1; 874; 2625; 5; 4388; 1763 
1; 875; 2628; 5; 4393; 1765 
1; 876; 2631; 5; 4398; 1767 
1; 877; 2634; 5; 4403; 1769 
1; 878; 2637; 5; 4408; 1771 
1; 879; 2640; 5; 4413; 1773 
1; 880; 2643; 5; 4418; 1775 
1; 881; 2646; 5; 4423; 1777 
1; 882; 2649; 5; 4428; 1779 
1; 883; 2652; 5; 4433; 1781 
1; 884; 2655; 5; 4438; 1783 
1; 885; 2658; 5; 4443; 1785 
1; 886; 2661; 5; 4448; 1787 
1; 887; 2664; 5; 4453; 1789 
1; 888; 2667; 5; 4458; 1791 
1; 889; 2670; 5; 4463; 1793 
1; 890; 2673; 5; 4468; 1795 
1; 891; 2676; 5; 4473; 1797 
1; 892; 2679; 5; 4478; 1799 
1; 893; 2682; 5; 4483; 1801 
1; 894; 2685; 5; 4488; 1803 
1; 895; 2688; 5; 4493; 1805 
1; 896; 2691; 5; 4498; 1807 
1; 897; 2694; 5; 4503; 1809 
1; 898; 2697; 5; 4508; 1811 
1; 899; 2700; 5; 4513; 1813 
1; 900; 2703; 5; 4518; 1815 
1; 901; 2706; 5; 4523; 1817 
1; 902; 2709; 5; 4528; 1819 
1; 903; 2712; 5; 4533; 1821 
1; 904; 2715; 5; 4538; 1823 
1; 905; 2718; 5; 4543; 1825 
1; 906; 2721; 5; 4548; 1827 
1; 907; 2724; 5; 4553; 1829 
1; 908; 2727; 5; 4558; 1831 
1; 909; 2730; 5; 4563; 1833 
1; 910; 2733; 5; 4568; 1835 
1; 911; 2736; 5; 4573; 1837 
1; 912; 2739; 5; 4578; 1839 
1; 913; 2742; 5; 4583; 1841 
1; 914; 2745; 5; 4588; 1843 
1; 915; 2748; 5; 4593; 1845 
1; 916; 2751; 5; 4598; 1847 
1; 917; 2754; 5; 4603; 1849 
1; 918; 2757; 5; 4608; 1851 
1; 919; 2760; 5; 4613; 1853 
1; 920; 2763; 5; 4618; 1855 
1; 921; 2766; 5; 4623; 1857 
1; 922; 2769; 5; 4628; 1859 
1; 923; 2772; 5; 4633; 1861 
1; 924; 2775; 5; 4638; 1863 
1; 925; 2778; 5; 4643; 1865 
1; 926; 2781; 5; 4648; 1867 
1; 927; 2784; 5; 4653; 1869 
1; 928; 2787; 5; 4658; 1871 
1; 929; 2790; 5; 4663; 1873 
1; 930; 2793; 5; 4668; 1875 
1; 931; 2796; 5; 4673; 1877 
1; 932; 2799; 5; 4678; 1879 
1; 933; 2802; 5; 4683; 1881 
1; 934; 2805; 5; 4688; 1883 
1; 935; 2808; 5; 4693; 1885 
1; 936; 2811; 5; 4698; 1887 
1; 937; 2814; 5; 4703; 1889 
1; 938; 2817; 5; 4708; 1891 
1; 939; 2820; 5; 4713; 1893 
1; 940; 2823; 5; 4718; 1895 
1; 941; 2826; 5; 4723; 1897 
1; 942; 2829; 5; 4728; 1899 
1; 943; 2832; 5; 4733; 1901 
1; 944; 2835; 5; 4738; 1903 
1; 945; 2838; 5; 4743; 1905 
1; 946; 2841; 5; 4748; 1907 
1; 947; 2844; 5; 4753; 1909 
1; 948; 2847; 5; 4758; 1911 
1; 949; 2850; 5; 4763; 1913 
1; 950; 2853; 5; 4768; 1915 
1; 951; 2856; 5; 4773; 1917 
1; 952; 2859; 5; 4778; 1919 
1; 953; 2862; 5; 4783; 1921 
1; 954; 2865; 5; 4788; 1923 
1; 955; 2868; 5; 4793; 1925 
1; 956; 2871; 5; 4798; 1927 
1; 957; 2874; 5; 4803; 1929 
1; 958; 2877; 5; 4808; 1931 
1; 959; 2880; 5; 4813; 1933 
1; 960; 2883; 5; 4818; 1935 
1; 961; 2886; 5; 4823; 1937 
1; 962; 2889; 5; 4828; 1939 
1; 963; 2892; 5; 4833; 1941 
1; 964; 2895; 5; 4838; 1943 
1; 965; 2898; 5; 4843; 1945 
1; 966; 2901; 5; 4848; 1947 
1; 967; 2904; 5; 4853; 1949 
1; 968; 2907; 5; 4858; 1951 
1; 969; 2910; 5; 4863; 1953 
1; 970; 2913; 5; 4868; 1955 
1; 971; 2916; 5; 4873; 1957 
1; 972; 2919; 5; 4878; 1959 
1; 973; 2922; 5; 4883; 1961 
1; 974; 2925; 5; 4888; 1963 
1; 975; 2928; 5; 4893; 1965 
1; 976; 2931; 5; 4898; 1967 
1; 977; 2934; 5; 4903; 1969 
1; 978; 2937; 5; 4908; 1971 
1; 979; 2940; 5; 4913; 1973 
1; 980; 2943; 5; 4918; 1975 
1; 981; 2946; 5; 4923; 1977 
1; 982; 2949; 5; 4928; 1979 
1; 983; 2952; 5; 4933; 1981 
1; 984; 2955; 5; 4938; 1983 
1; 985; 2958; 5; 4943; 1985 
1; 986; 2961; 5; 4948; 1987 
1; 987; 2964; 5; 4953; 1989 
1; 988; 2967; 5; 4958; 1991 
1; 989; 2970; 5; 4963; 1993 
1; 990; 2973; 5; 4968; 1995 
1; 991; 2976; 5; 4973; 1997 
1; 992; 2979; 5; 4978; 1999 
1; 993; 2982; 5; 4983; 2001 
1; 994; 2985; 5; 4988; 2003 
1; 995; 2988; 5; 4993; 2005 
1; 996; 2991; 5; 4998; 2007 
1; 997; 2994; 5; 5003; 2009 
1; 998; 2997; 5; 5008; 2011 
1; 999; 3000; 5; 5013; 2013 
1; 1000; 3003; 5; 5018; 2015 
1; 1001; 3006; 5; 5023; 2017 
1; 1002; 3009; 5; 5028; 2019 
1; 1003; 3012; 5; 5033; 2021 
1; 1004; 3015; 5; 5038; 2023 
1; 1005; 3018; 5; 5043; 2025 
1; 1006; 3021; 5; 5048; 2027 
1; 1007; 3024; 5; 5053; 2029 
1; 1008; 3027; 5; 5058; 2031 
1; 1009; 3030; 5; 5063; 2033 
1; 1010; 3033; 5; 5068; 2035 
1; 1011; 3036; 5; 5073; 2037 
1; 1012; 3039; 5; 5078; 2039 
1; 1013; 3042; 5; 5083; 2041 
1; 1014; 3045; 5; 5088; 2043 
1; 1015; 3048; 5; 5093; 2045 
1; 1016; 3051; 5; 5098; 2047 
1; 1017; 3054; 5; 5103; 2049 
1; 1018; 3057; 5; 5108; 2051 
1; 1019; 3060; 5; 5113; 2053 
1; 1020; 3063; 5; 5118; 2055 
1; 1021; 3066; 5; 5123; 2057 
1; 1022; 3069; 5; 5128; 2059 
1; 1023; 3072; 5; 5133; 2061 
1; 1024; 3075; 5; 5138; 2063 
1; 1025; 3078; 5; 5143; 2065 
1; 1026; 3081; 5; 5148; 2067 
1; 1027; 3084; 5; 5153; 2069 
1; 1028; 3087; 5; 5158; 2071 
1; 1029; 3090; 5; 5163; 2073 
1; 1030; 3093; 5; 5168; 2075 
1; 1031; 3096; 5; 5173; 2077 
1; 1032; 3099; 5; 5178; 2079 
1; 1033; 3102; 5; 5183; 2081 
1; 1034; 3105; 5; 5188; 2083 
1; 1035; 3108; 5; 5193; 2085 
1; 1036; 3111; 5; 5198; 2087 
1; 1037; 3114; 5; 5203; 2089 
1; 1038; 3117; 5; 5208; 2091 
1; 1039; 3120; 5; 5213; 2093 
1; 1040; 3123; 5; 5218; 2095 
1; 1041; 3126; 5; 5223; 2097 
1; 1042; 3129; 5; 5228; 2099 
1; 1043; 3132; 5; 5233; 2101 
1; 1044; 3135; 5; 5238; 2103 
1; 1045; 3138; 5; 5243; 2105 
1; 1046; 3141; 5; 5248; 2107 
1; 1047; 3144; 5; 5253; 2109 
1; 1048; 3147; 5; 5258; 2111 
1; 1049; 3150; 5; 5263; 2113 
1; 1050; 3153; 5; 5268; 2115 
1; 1051; 3156; 5; 5273; 2117 
1; 1052; 3159; 5; 5278; 2119 
1; 1053; 3162; 5; 5283; 2121 
1; 1054; 3165; 5; 5288; 2123 
1; 1055; 3168; 5; 5293; 2125 
1; 1056; 3171; 5; 5298; 2127 
1; 1057; 3174; 5; 5303; 2129 
1; 1058; 3177; 5; 5308; 2131 
1; 1059; 3180; 5; 5313; 2133 
1; 1060; 3183; 5; 5318; 2135 
1; 1061; 3186; 5; 5323; 2137 
1; 1062; 3189; 5; 5328; 2139 
1; 1063; 3192; 5; 5333; 2141 
1; 1064; 3195; 5; 5338; 2143 
1; 1065; 3198; 5; 5343; 2145 
1; 1066; 3201; 5; 5348; 2147 
1; 1067; 3204; 5; 5353; 2149 
1; 1068; 3207; 5; 5358; 2151 
1; 1069; 3210; 5; 5363; 2153 
1; 1070; 3213; 5; 5368; 2155 
1; 1071; 3216; 5; 5373; 2157 
1; 1072; 3219; 5; 5378; 2159 
1; 1073; 3222; 5; 5383; 2161 
1; 1074; 3225; 5; 5388; 2163 
1; 1075; 3228; 5; 5393; 2165 
1; 1076; 3231; 5; 5398; 2167 
1; 1077; 3234; 5; 5403; 2169 
1; 1078; 3237; 5; 5408; 2171 
1; 1079; 3240; 5; 5413; 2173 
1; 1080; 3243; 5; 5418; 2175 
1; 1081; 3246; 5; 5423; 2177 
1; 1082; 3249; 5; 5428; 2179 
1; 1083; 3252; 5; 5433; 2181 
1; 1084; 3255; 5; 5438; 2183 
1; 1085; 3258; 5; 5443; 2185 
1; 1086; 3261; 5; 5448; 2187 
1; 1087; 3264; 5; 5453; 2189 
1; 1088; 3267; 5; 5458; 2191 
1; 1089; 3270; 5; 5463; 2193 
1; 1090; 3273; 5; 5468; 2195 
1; 1091; 3276; 5; 5473; 2197 
1; 1092; 3279; 5; 5478; 2199 
1; 1093; 3282; 5; 5483; 2201 
1; 1094; 3285; 5; 5488; 2203 
1; 1095; 3288; 5; 5493; 2205 
1; 1096; 3291; 5; 5498; 2207 
1; 1097; 3294; 5; 5503; 2209 
1; 1098; 3297; 5; 5508; 2211 
1; 1099; 3300; 5; 5513; 2213 
1; 1100; 3303; 5; 5518; 2215 
1; 1101; 3306; 5; 5523; 2217 
1; 1102; 3309; 5; 5528; 2219 
1; 1103; 3312; 5; 5533; 2221 
1; 1104; 3315; 5; 5538; 2223 
1; 1105; 3318; 5; 5543; 2225 
1; 1106; 3321; 5; 5548; 2227 
1; 1107; 3324; 5; 5553; 2229 
1; 1108; 3327; 5; 5558; 2231 
1; 1109; 3330; 5; 5563; 2233 
1; 1110; 3333; 5; 5568; 2235 
1; 1111; 3336; 5; 5573; 2237 
1; 1112; 3339; 5; 5578; 2239 
1; 1113; 3342; 5; 5583; 2241 
1; 1114; 3345; 5; 5588; 2243 
1; 1115; 3348; 5; 5593; 2245 
1; 1116; 3351; 5; 5598; 2247 
1; 1117; 3354; 5; 5603; 2249 
1; 1118; 3357; 5; 5608; 2251 
1; 1119; 3360; 5; 5613; 2253 
1; 1120; 3363; 5; 5618; 2255 
1; 1121; 3366; 5; 5623; 2257 
1; 1122; 3369; 5; 5628; 2259 
1; 1123; 3372; 5; 5633; 2261 
1; 1124; 3375; 5; 5638; 2263 
1; 1125; 3378; 5; 5643; 2265 
1; 1126; 3381; 5; 5648; 2267 
1; 1127; 3384; 5; 5653; 2269 
1; 1128; 3387; 5; 5658; 2271 
1; 1129; 3390; 5; 5663; 2273 
1; 1130; 3393; 5; 5668; 2275 
1; 1131; 3396; 5; 5673; 2277 
1; 1132; 3399; 5; 5678; 2279 
1; 1133; 3402; 5; 5683; 2281 
1; 1134; 3405; 5; 5688; 2283 
1; 1135; 3408; 5; 5693; 2285 
1; 1136; 3411; 5; 5698; 2287 
1; 1137; 3414; 5; 5703; 2289 
1; 1138; 3417; 5; 5708; 2291 
1; 1139; 3420; 5; 5713; 2293 
1; 1140; 3423; 5; 5718; 2295 
1; 1141; 3426; 5; 5723; 2297 
1; 1142; 3429; 5; 5728; 2299 
1; 1143; 3432; 5; 5733; 2301 
1; 1144; 3435; 5; 5738; 2303 
1; 1145; 3438; 5; 5743; 2305 
1; 1146; 3441; 5; 5748; 2307 
1; 1147; 3444; 5; 5753; 2309 
1; 1148; 3447; 5; 5758; 2311 
1; 1149; 3450; 5; 5763; 2313 
1; 1150; 3453; 5; 5768; 2315 
1; 1151; 3456; 5; 5773; 2317 
1; 1152; 3459; 5; 5778; 2319 
1; 1153; 3462; 5; 5783; 2321 
1; 1154; 3465; 5; 5788; 2323 
1; 1155; 3468; 5; 5793; 2325 
1; 1156; 3471; 5; 5798; 2327 
1; 1157; 3474; 5; 5803; 2329 
1; 1158; 3477; 5; 5808; 2331 
1; 1159; 3480; 5; 5813; 2333 
1; 1160; 3483; 5; 5818; 2335 
1; 1161; 3486; 5; 5823; 2337 
1; 1162; 3489; 5; 5828; 2339 
1; 1163; 3492; 5; 5833; 2341 
1; 1164; 3495; 5; 5838; 2343 
1; 1165; 3498; 5; 5843; 2345 
1; 1166; 3501; 5; 5848; 2347 
1; 1167; 3504; 5; 5853; 2349 
1; 1168; 3507; 5; 5858; 2351 
1; 1169; 3510; 5; 5863; 2353 
1; 1170; 3513; 5; 5868; 2355 
1; 1171; 3516; 5; 5873; 2357 
1; 1172; 3519; 5; 5878; 2359 
1; 1173; 3522; 5; 5883; 2361 
1; 1174; 3525; 5; 5888; 2363 
1; 1175; 3528; 5; 5893; 2365 
1; 1176; 3531; 5; 5898; 2367 
1; 1177; 3534; 5; 5903; 2369 
1; 1178; 3537; 5; 5908; 2371 
1; 1179; 3540; 5; 5913; 2373 
1; 1180; 3543; 5; 5918; 2375 
1; 1181; 3546; 5; 5923; 2377 
1; 1182; 3549; 5; 5928; 2379 
1; 1183; 3552; 5; 5933; 2381 
1; 1184; 3555; 5; 5938; 2383 
1; 1185; 3558; 5; 5943; 2385 
1; 1186; 3561; 5; 5948; 2387 
1; 1187; 3564; 5; 5953; 2389 
1; 1188; 3567; 5; 5958; 2391 
1; 1189; 3570; 5; 5963; 2393 
1; 1190; 3573; 5; 5968; 2395 
1; 1191; 3576; 5; 5973; 2397 
1; 1192; 3579; 5; 5978; 2399 
1; 1193; 3582; 5; 5983; 2401 
1; 1194; 3585; 5; 5988; 2403 
1; 1195; 3588; 5; 5993; 2405 
1; 1196; 3591; 5; 5998; 2407 
1; 1197; 3594; 5; 6003; 2409 
1; 1198; 3597; 5; 6008; 2411 
1; 1199; 3600; 5; 6013; 2413 
1; 1200; 3603; 5; 6018; 2415 
1; 1201; 3606; 5; 6023; 2417 
1; 1202; 3609; 5; 6028; 2419 
1; 1203; 3612; 5; 6033; 2421 
1; 1204; 3615; 5; 6038; 2423 
1; 1205; 3618; 5; 6043; 2425 
1; 1206; 3621; 5; 6048; 2427 
1; 1207; 3624; 5; 6053; 2429 
1; 1208; 3627; 5; 6058; 2431 
1; 1209; 3630; 5; 6063; 2433 
1; 1210; 3633; 5; 6068; 2435 
1; 1211; 3636; 5; 6073; 2437 
1; 1212; 3639; 5; 6078; 2439 
1; 1213; 3642; 5; 6083; 2441 
1; 1214; 3645; 5; 6088; 2443 
1; 1215; 3648; 5; 6093; 2445 
1; 1216; 3651; 5; 6098; 2447 
1; 1217; 3654; 5; 6103; 2449 
1; 1218; 3657; 5; 6108; 2451 
1; 1219; 3660; 5; 6113; 2453 
1; 1220; 3663; 5; 6118; 2455 
1; 1221; 3666; 5; 6123; 2457 
1; 1222; 3669; 5; 6128; 2459 
1; 1223; 3672; 5; 6133; 2461 
1; 1224; 3675; 5; 6138; 2463 
1; 1225; 3678; 5; 6143; 2465 
1; 1226; 3681; 5; 6148; 2467 
1; 1227; 3684; 5; 6153; 2469 
1; 1228; 3687; 5; 6158; 2471 
1; 1229; 3690; 5; 6163; 2473 
1; 1230; 3693; 5; 6168; 2475 
1; 1231; 3696; 5; 6173; 2477 
1; 1232; 3699; 5; 6178; 2479 
1; 1233; 3702; 5; 6183; 2481 
1; 1234; 3705; 5; 6188; 2483 
1; 1235; 3708; 5; 6193; 2485 
1; 1236; 3711; 5; 6198; 2487 
1; 1237; 3714; 5; 6203; 2489 
1; 1238; 3717; 5; 6208; 2491 
1; 1239; 3720; 5; 6213; 2493 
1; 1240; 3723; 5; 6218; 2495 
1; 1241; 3726; 5; 6223; 2497 
1; 1242; 3729; 5; 6228; 2499 
1; 1243; 3732; 5; 6233; 2501 
1; 1244; 3735; 5; 6238; 2503 
1; 1245; 3738; 5; 6243; 2505 
1; 1246; 3741; 5; 6248; 2507 
1; 1247; 3744; 5; 6253; 2509 
1; 1248; 3747; 5; 6258; 2511 
1; 1249; 3750; 5; 6263; 2513 
1; 1250; 3753; 5; 6268; 2515 
1; 1251; 3756; 5; 6273; 2517 
1; 1252; 3759; 5; 6278; 2519 
1; 1253; 3762; 5; 6283; 2521 
1; 1254; 3765; 5; 6288; 2523 
1; 1255; 3768; 5; 6293; 2525 
1; 1256; 3771; 5; 6298; 2527 
1; 1257; 3774; 5; 6303; 2529 
1; 1258; 3777; 5; 6308; 2531 
1; 1259; 3780; 5; 6313; 2533 
1; 1260; 3783; 5; 6318; 2535 
1; 1261; 3786; 5; 6323; 2537 
1; 1262; 3789; 5; 6328; 2539 
1; 1263; 3792; 5; 6333; 2541 
1; 1264; 3795; 5; 6338; 2543 
1; 1265; 3798; 5; 6343; 2545 
1; 1266; 3801; 5; 6348; 2547 
1; 1267; 3804; 5; 6353; 2549 
1; 1268; 3807; 5; 6358; 2551 
1; 1269; 3810; 5; 6363; 2553 
1; 1270; 3813; 5; 6368; 2555 
1; 1271; 3816; 5; 6373; 2557 
1; 1272; 3819; 5; 6378; 2559 
1; 1273; 3822; 5; 6383; 2561 
1; 1274; 3825; 5; 6388; 2563 
1; 1275; 3828; 5; 6393; 2565 
1; 1276; 3831; 5; 6398; 2567 
1; 1277; 3834; 5; 6403; 2569 
1; 1278; 3837; 5; 6408; 2571 
1; 1279; 3840; 5; 6413; 2573 
1; 1280; 3843; 5; 6418; 2575 
1; 1281; 3846; 5; 6423; 2577 
1; 1282; 3849; 5; 6428; 2579 
1; 1283; 3852; 5; 6433; 2581 
1; 1284; 3855; 5; 6438; 2583 
1; 1285; 3858; 5; 6443; 2585 
1; 1286; 3861; 5; 6448; 2587 
1; 1287; 3864; 5; 6453; 2589 
1; 1288; 3867; 5; 6458; 2591 
1; 1289; 3870; 5; 6463; 2593 
1; 1290; 3873; 5; 6468; 2595 
1; 1291; 3876; 5; 6473; 2597 
1; 1292; 3879; 5; 6478; 2599 
1; 1293; 3882; 5; 6483; 2601 
1; 1294; 3885; 5; 6488; 2603 
1; 1295; 3888; 5; 6493; 2605 
1; 1296; 3891; 5; 6498; 2607 
1; 1297; 3894; 5; 6503; 2609 
1; 1298; 3897; 5; 6508; 2611 
1; 1299; 3900; 5; 6513; 2613 
1; 1300; 3903; 5; 6518; 2615 
1; 1301; 3906; 5; 6523; 2617 
1; 1302; 3909; 5; 6528; 2619 
1; 1303; 3912; 5; 6533; 2621 
1; 1304; 3915; 5; 6538; 2623 
1; 1305; 3918; 5; 6543; 2625 
1; 1306; 3921; 5; 6548; 2627 
1; 1307; 3924; 5; 6553; 2629 
1; 1308; 3927; 5; 6558; 2631 
1; 1309; 3930; 5; 6563; 2633 
1; 1310; 3933; 5; 6568; 2635 
1; 1311; 3936; 5; 6573; 2637 
1; 1312; 3939; 5; 6578; 2639 
1; 1313; 3942; 5; 6583; 2641 
1; 1314; 3945; 5; 6588; 2643 
1; 1315; 3948; 5; 6593; 2645 
1; 1316; 3951; 5; 6598; 2647 
1; 1317; 3954; 5; 6603; 2649 
1; 1318; 3957; 5; 6608; 2651 
1; 1319; 3960; 5; 6613; 2653 
1; 1320; 3963; 5; 6618; 2655 
1; 1321; 3966; 5; 6623; 2657 
1; 1322; 3969; 5; 6628; 2659 
1; 1323; 3972; 5; 6633; 2661 
1; 1324; 3975; 5; 6638; 2663 
1; 1325; 3978; 5; 6643; 2665 
1; 1326; 3981; 5; 6648; 2667 
1; 1327; 3984; 5; 6653; 2669 
1; 1328; 3987; 5; 6658; 2671 
1; 1329; 3990; 5; 6663; 2673 
1; 1330; 3993; 5; 6668; 2675 
1; 1331; 3996; 5; 6673; 2677 
1; 1332; 3999; 5; 6678; 2679 
1; 1333; 4002; 5; 6683; 2681 
1; 1334; 4005; 5; 6688; 2683 
1; 1335; 4008; 5; 6693; 2685 
1; 1336; 4011; 5; 6698; 2687 
1; 1337; 4014; 5; 6703; 2689 
1; 1338; 4017; 5; 6708; 2691 
1; 1339; 4020; 5; 6713; 2693 
1; 1340; 4023; 5; 6718; 2695 
1; 1341; 4026; 5; 6723; 2697 
1; 1342; 4029; 5; 6728; 2699 
1; 1343; 4032; 5; 6733; 2701 
1; 1344; 4035; 5; 6738; 2703 
1; 1345; 4038; 5; 6743; 2705 
1; 1346; 4041; 5; 6748; 2707 
1; 1347; 4044; 5; 6753; 2709 
1; 1348; 4047; 5; 6758; 2711 
1; 1349; 4050; 5; 6763; 2713 
1; 1350; 4053; 5; 6768; 2715 
1; 1351; 4056; 5; 6773; 2717 
1; 1352; 4059; 5; 6778; 2719 
1; 1353; 4062; 5; 6783; 2721 
1; 1354; 4065; 5; 6788; 2723 
1; 1355; 4068; 5; 6793; 2725 
1; 1356; 4071; 5; 6798; 2727 
1; 1357; 4074; 5; 6803; 2729 
1; 1358; 4077; 5; 6808; 2731 
1; 1359; 4080; 5; 6813; 2733 
1; 1360; 4083; 5; 6818; 2735 
1; 1361; 4086; 5; 6823; 2737 
1; 1362; 4089; 5; 6828; 2739 
1; 1363; 4092; 5; 6833; 2741 
1; 1364; 4095; 5; 6838; 2743 
1; 1365; 4098; 5; 6843; 2745 
1; 1366; 4101; 5; 6848; 2747 
1; 1367; 4104; 5; 6853; 2749 
1; 1368; 4107; 5; 6858; 2751 
1; 1369; 4110; 5; 6863; 2753 
1; 1370; 4113; 5; 6868; 2755 
1; 1371; 4116; 5; 6873; 2757 
1; 1372; 4119; 5; 6878; 2759 
1; 1373; 4122; 5; 6883; 2761 
1; 1374; 4125; 5; 6888; 2763 
1; 1375; 4128; 5; 6893; 2765 
1; 1376; 4131; 5; 6898; 2767 
1; 1377; 4134; 5; 6903; 2769 
1; 1378; 4137; 5; 6908; 2771 
1; 1379; 4140; 5; 6913; 2773 
1; 1380; 4143; 5; 6918; 2775 
1; 1381; 4146; 5; 6923; 2777 
1; 1382; 4149; 5; 6928; 2779 
1; 1383; 4152; 5; 6933; 2781 
1; 1384; 4155; 5; 6938; 2783 
1; 1385; 4158; 5; 6943; 2785 
1; 1386; 4161; 5; 6948; 2787 
1; 1387; 4164; 5; 6953; 2789 
1; 1388; 4167; 5; 6958; 2791 
1; 1389; 4170; 5; 6963; 2793 
1; 1390; 4173; 5; 6968; 2795 
1; 1391; 4176; 5; 6973; 2797 
1; 1392; 4179; 5; 6978; 2799 
1; 1393; 4182; 5; 6983; 2801 
1; 1394; 4185; 5; 6988; 2803 
1; 1395; 4188; 5; 6993; 2805 
1; 1396; 4191; 5; 6998; 2807 
1; 1397; 4194; 5; 7003; 2809 
1; 1398; 4197; 5; 7008; 2811 
1; 1399; 4200; 5; 7013; 2813 
1; 1400; 4203; 5; 7018; 2815 
1; 1401; 4206; 5; 7023; 2817 
1; 1402; 4209; 5; 7028; 2819 
1; 1403; 4212; 5; 7033; 2821 
1; 1404; 4215; 5; 7038; 2823 
1; 1405; 4218; 5; 7043; 2825 
1; 1406; 4221; 5; 7048; 2827 
1; 1407; 4224; 5; 7053; 2829 
1; 1408; 4227; 5; 7058; 2831 
1; 1409; 4230; 5; 7063; 2833 
1; 1410; 4233; 5; 7068; 2835 
1; 1411; 4236; 5; 7073; 2837 
1; 1412; 4239; 5; 7078; 2839 
1; 1413; 4242; 5; 7083; 2841 
1; 1414; 4245; 5; 7088; 2843 
1; 1415; 4248; 5; 7093; 2845 
1; 1416; 4251; 5; 7098; 2847 
1; 1417; 4254; 5; 7103; 2849 
1; 1418; 4257; 5; 7108; 2851 
1; 1419; 4260; 5; 7113; 2853 
1; 1420; 4263; 5; 7118; 2855 
1; 1421; 4266; 5; 7123; 2857 
1; 1422; 4269; 5; 7128; 2859 
1; 1423; 4272; 5; 7133; 2861 
1; 1424; 4275; 5; 7138; 2863 
1; 1425; 4278; 5; 7143; 2865 
1; 1426; 4281; 5; 7148; 2867 
1; 1427; 4284; 5; 7153; 2869 
1; 1428; 4287; 5; 7158; 2871 
1; 1429; 4290; 5; 7163; 2873 
1; 1430; 4293; 5; 7168; 2875 
1; 1431; 4296; 5; 7173; 2877 
1; 1432; 4299; 5; 7178; 2879 
1; 1433; 4302; 5; 7183; 2881 
1; 1434; 4305; 5; 7188; 2883 
1; 1435; 4308; 5; 7193; 2885 
1; 1436; 4311; 5; 7198; 2887 
1; 1437; 4314; 5; 7203; 2889 
1; 1438; 4317; 5; 7208; 2891 
1; 1439; 4320; 5; 7213; 2893 
1; 1440; 4323; 5; 7218; 2895 
1; 1441; 4326; 5; 7223; 2897 
1; 1442; 4329; 5; 7228; 2899 
1; 1443; 4332; 5; 7233; 2901 
1; 1444; 4335; 5; 7238; 2903 
1; 1445; 4338; 5; 7243; 2905 
1; 1446; 4341; 5; 7248; 2907 
1; 1447; 4344; 5; 7253; 2909 
1; 1448; 4347; 5; 7258; 2911 
1; 1449; 4350; 5; 7263; 2913 
1; 1450; 4353; 5; 7268; 2915 
1; 1451; 4356; 5; 7273; 2917 
1; 1452; 4359; 5; 7278; 2919 
1; 1453; 4362; 5; 7283; 2921 
1; 1454; 4365; 5; 7288; 2923 
1; 1455; 4368; 5; 7293; 2925 
1; 1456; 4371; 5; 7298; 2927 
1; 1457; 4374; 5; 7303; 2929 
1; 1458; 4377; 5; 7308; 2931 
1; 1459; 4380; 5; 7313; 2933 
1; 1460; 4383; 5; 7318; 2935 
1; 1461; 4386; 5; 7323; 2937 
1; 1462; 4389; 5; 7328; 2939 
1; 1463; 4392; 5; 7333; 2941 
1; 1464; 4395; 5; 7338; 2943 
1; 1465; 4398; 5; 7343; 2945 
1; 1466; 4401; 5; 7348; 2947 
1; 1467; 4404; 5; 7353; 2949 
1; 1468; 4407; 5; 7358; 2951 
1; 1469; 4410; 5; 7363; 2953 
1; 1470; 4413; 5; 7368; 2955 
1; 1471; 4416; 5; 7373; 2957 
1; 1472; 4419; 5; 7378; 2959 
1; 1473; 4422; 5; 7383; 2961 
1; 1474; 4425; 5; 7388; 2963 
1; 1475; 4428; 5; 7393; 2965 
1; 1476; 4431; 5; 7398; 2967 
1; 1477; 4434; 5; 7403; 2969 
1; 1478; 4437; 5; 7408; 2971 
1; 1479; 4440; 5; 7413; 2973 
1; 1480; 4443; 5; 7418; 2975 
1; 1481; 4446; 5; 7423; 2977 
1; 1482; 4449; 5; 7428; 2979 
1; 1483; 4452; 5; 7433; 2981 
1; 1484; 4455; 5; 7438; 2983 
1; 1485; 4458; 5; 7443; 2985 
1; 1486; 4461; 5; 7448; 2987 
1; 1487; 4464; 5; 7453; 2989 
1; 1488; 4467; 5; 7458; 2991 
1; 1489; 4470; 5; 7463; 2993 
1; 1490; 4473; 5; 7468; 2995 
1; 1491; 4476; 5; 7473; 2997 
1; 1492; 4479; 5; 7478; 2999 
1; 1493; 4482; 5; 7483; 3001 
1; 1494; 4485; 5; 7488; 3003 
1; 1495; 4488; 5; 7493; 3005 
1; 1496; 4491; 5; 7498; 3007 
1; 1497; 4494; 5; 7503; 3009 
1; 1498; 4497; 5; 7508; 3011 
1; 1499; 4500; 5; 7513; 3013 
1; 1500; 4503; 5; 7518; 3015 
1; 1501; 4506; 5; 7523; 3017 
1; 1502; 4509; 5; 7528; 3019 
1; 1503; 4512; 5; 7533; 3021 
1; 1504; 4515; 5; 7538; 3023 
1; 1505; 4518; 5; 7543; 3025 
1; 1506; 4521; 5; 7548; 3027 
1; 1507; 4524; 5; 7553; 3029 
1; 1508; 4527; 5; 7558; 3031 
1; 1509; 4530; 5; 7563; 3033 
1; 1510; 4533; 5; 7568; 3035 
1; 1511; 4536; 5; 7573; 3037 
1; 1512; 4539; 5; 7578; 3039 
1; 1513; 4542; 5; 7583; 3041 
1; 1514; 4545; 5; 7588; 3043 
1; 1515; 4548; 5; 7593; 3045 
1; 1516; 4551; 5; 7598; 3047 
1; 1517; 4554; 5; 7603; 3049 
1; 1518; 4557; 5; 7608; 3051 
1; 1519; 4560; 5; 7613; 3053 
1; 1520; 4563; 5; 7618; 3055 
1; 1521; 4566; 5; 7623; 3057 
1; 1522; 4569; 5; 7628; 3059 
1; 1523; 4572; 5; 7633; 3061 
1; 1524; 4575; 5; 7638; 3063 
1; 1525; 4578; 5; 7643; 3065 
1; 1526; 4581; 5; 7648; 3067 
1; 1527; 4584; 5; 7653; 3069 
1; 1528; 4587; 5; 7658; 3071 
1; 1529; 4590; 5; 7663; 3073 
1; 1530; 4593; 5; 7668; 3075 
1; 1531; 4596; 5; 7673; 3077 
1; 1532; 4599; 5; 7678; 3079 
1; 1533; 4602; 5; 7683; 3081 
1; 1534; 4605; 5; 7688; 3083 
1; 1535; 4608; 5; 7693; 3085 
1; 1536; 4611; 5; 7698; 3087 
1; 1537; 4614; 5; 7703; 3089 
1; 1538; 4617; 5; 7708; 3091 
1; 1539; 4620; 5; 7713; 3093 
1; 1540; 4623; 5; 7718; 3095 
1; 1541; 4626; 5; 7723; 3097 
1; 1542; 4629; 5; 7728; 3099 
1; 1543; 4632; 5; 7733; 3101 
1; 1544; 4635; 5; 7738; 3103 
1; 1545; 4638; 5; 7743; 3105 
1; 1546; 4641; 5; 7748; 3107 
1; 1547; 4644; 5; 7753; 3109 
1; 1548; 4647; 5; 7758; 3111 
1; 1549; 4650; 5; 7763; 3113 
1; 1550; 4653; 5; 7768; 3115 
1; 1551; 4656; 5; 7773; 3117 
1; 1552; 4659; 5; 7778; 3119 
1; 1553; 4662; 5; 7783; 3121 
1; 1554; 4665; 5; 7788; 3123 
1; 1555; 4668; 5; 7793; 3125 
1; 1556; 4671; 5; 7798; 3127 
1; 1557; 4674; 5; 7803; 3129 
1; 1558; 4677; 5; 7808; 3131 
1; 1559; 4680; 5; 7813; 3133 
1; 1560; 4683; 5; 7818; 3135 
1; 1561; 4686; 5; 7823; 3137 
1; 1562; 4689; 5; 7828; 3139 
1; 1563; 4692; 5; 7833; 3141 
1; 1564; 4695; 5; 7838; 3143 
1; 1565; 4698; 5; 7843; 3145 
1; 1566; 4701; 5; 7848; 3147 
1; 1567; 4704; 5; 7853; 3149 
1; 1568; 4707; 5; 7858; 3151 
1; 1569; 4710; 5; 7863; 3153 
1; 1570; 4713; 5; 7868; 3155 
1; 1571; 4716; 5; 7873; 3157 
1; 1572; 4719; 5; 7878; 3159 
1; 1573; 4722; 5; 7883; 3161 
1; 1574; 4725; 5; 7888; 3163 
1; 1575; 4728; 5; 7893; 3165 
1; 1576; 4731; 5; 7898; 3167 
1; 1577; 4734; 5; 7903; 3169 
1; 1578; 4737; 5; 7908; 3171 
1; 1579; 4740; 5; 7913; 3173 
1; 1580; 4743; 5; 7918; 3175 
1; 1581; 4746; 5; 7923; 3177 
1; 1582; 4749; 5; 7928; 3179 
1; 1583; 4752; 5; 7933; 3181 
1; 1584; 4755; 5; 7938; 3183 
1; 1585; 4758; 5; 7943; 3185 
1; 1586; 4761; 5; 7948; 3187 
1; 1587; 4764; 5; 7953; 3189 
1; 1588; 4767; 5; 7958; 3191 
1; 1589; 4770; 5; 7963; 3193 
1; 1590; 4773; 5; 7968; 3195 
1; 1591; 4776; 5; 7973; 3197 
1; 1592; 4779; 5; 7978; 3199 
1; 1593; 4782; 5; 7983; 3201 
1; 1594; 4785; 5; 7988; 3203 
1; 1595; 4788; 5; 7993; 3205 
1; 1596; 4791; 5; 7998; 3207 
1; 1597; 4794; 5; 8003; 3209 
1; 1598; 4797; 5; 8008; 3211 
1; 1599; 4800; 5; 8013; 3213 
1; 1600; 4803; 5; 8018; 3215 
1; 1601; 4806; 5; 8023; 3217 
1; 1602; 4809; 5; 8028; 3219 
1; 1603; 4812; 5; 8033; 3221 
1; 1604; 4815; 5; 8038; 3223 
1; 1605; 4818; 5; 8043; 3225 
1; 1606; 4821; 5; 8048; 3227 
1; 1607; 4824; 5; 8053; 3229 
1; 1608; 4827; 5; 8058; 3231 
1; 1609; 4830; 5; 8063; 3233 
1; 1610; 4833; 5; 8068; 3235 
1; 1611; 4836; 5; 8073; 3237 
1; 1612; 4839; 5; 8078; 3239 
1; 1613; 4842; 5; 8083; 3241 
1; 1614; 4845; 5; 8088; 3243 
1; 1615; 4848; 5; 8093; 3245 
1; 1616; 4851; 5; 8098; 3247 
1; 1617; 4854; 5; 8103; 3249 
1; 1618; 4857; 5; 8108; 3251 
1; 1619; 4860; 5; 8113; 3253 
1; 1620; 4863; 5; 8118; 3255 
1; 1621; 4866; 5; 8123; 3257 
1; 1622; 4869; 5; 8128; 3259 
1; 1623; 4872; 5; 8133; 3261 
1; 1624; 4875; 5; 8138; 3263 
1; 1625; 4878; 5; 8143; 3265 
1; 1626; 4881; 5; 8148; 3267 
1; 1627; 4884; 5; 8153; 3269 
1; 1628; 4887; 5; 8158; 3271 
1; 1629; 4890; 5; 8163; 3273 
1; 1630; 4893; 5; 8168; 3275 
1; 1631; 4896; 5; 8173; 3277 
1; 1632; 4899; 5; 8178; 3279 
1; 1633; 4902; 5; 8183; 3281 
1; 1634; 4905; 5; 8188; 3283 
1; 1635; 4908; 5; 8193; 3285 
1; 1636; 4911; 5; 8198; 3287 
1; 1637; 4914; 5; 8203; 3289 
1; 1638; 4917; 5; 8208; 3291 
1; 1639; 4920; 5; 8213; 3293 
1; 1640; 4923; 5; 8218; 3295 
1; 1641; 4926; 5; 8223; 3297 
1; 1642; 4929; 5; 8228; 3299 
1; 1643; 4932; 5; 8233; 3301 
1; 1644; 4935; 5; 8238; 3303 
1; 1645; 4938; 5; 8243; 3305 
1; 1646; 4941; 5; 8248; 3307 
1; 1647; 4944; 5; 8253; 3309 
1; 1648; 4947; 5; 8258; 3311 
1; 1649; 4950; 5; 8263; 3313 
1; 1650; 4953; 5; 8268; 3315 
1; 1651; 4956; 5; 8273; 3317 
1; 1652; 4959; 5; 8278; 3319 
1; 1653; 4962; 5; 8283; 3321 
1; 1654; 4965; 5; 8288; 3323 
1; 1655; 4968; 5; 8293; 3325 
1; 1656; 4971; 5; 8298; 3327 
1; 1657; 4974; 5; 8303; 3329 
1; 1658; 4977; 5; 8308; 3331 
1; 1659; 4980; 5; 8313; 3333 
1; 1660; 4983; 5; 8318; 3335 
1; 1661; 4986; 5; 8323; 3337 
1; 1662; 4989; 5; 8328; 3339 
1; 1663; 4992; 5; 8333; 3341 
1; 1664; 4995; 5; 8338; 3343 
1; 1665; 4998; 5; 8343; 3345 
1; 1666; 5001; 5; 8348; 3347 
1; 1667; 5004; 5; 8353; 3349 
1; 1668; 5007; 5; 8358; 3351 
1; 1669; 5010; 5; 8363; 3353 
1; 1670; 5013; 5; 8368; 3355 
1; 1671; 5016; 5; 8373; 3357 
1; 1672; 5019; 5; 8378; 3359 
1; 1673; 5022; 5; 8383; 3361 
1; 1674; 5025; 5; 8388; 3363 
1; 1675; 5028; 5; 8393; 3365 
1; 1676; 5031; 5; 8398; 3367 
1; 1677; 5034; 5; 8403; 3369 
1; 1678; 5037; 5; 8408; 3371 
1; 1679; 5040; 5; 8413; 3373 
1; 1680; 5043; 5; 8418; 3375 
1; 1681; 5046; 5; 8423; 3377 
1; 1682; 5049; 5; 8428; 3379 
1; 1683; 5052; 5; 8433; 3381 
1; 1684; 5055; 5; 8438; 3383 
1; 1685; 5058; 5; 8443; 3385 
1; 1686; 5061; 5; 8448; 3387 
1; 1687; 5064; 5; 8453; 3389 
1; 1688; 5067; 5; 8458; 3391 
1; 1689; 5070; 5; 8463; 3393 
1; 1690; 5073; 5; 8468; 3395 
1; 1691; 5076; 5; 8473; 3397 
1; 1692; 5079; 5; 8478; 3399 
1; 1693; 5082; 5; 8483; 3401 
1; 1694; 5085; 5; 8488; 3403 
1; 1695; 5088; 5; 8493; 3405 
1; 1696; 5091; 5; 8498; 3407 
1; 1697; 5094; 5; 8503; 3409 
1; 1698; 5097; 5; 8508; 3411 
1; 1699; 5100; 5; 8513; 3413 
1; 1700; 5103; 5; 8518; 3415 
1; 1701; 5106; 5; 8523; 3417 
1; 1702; 5109; 5; 8528; 3419 
1; 1703; 5112; 5; 8533; 3421 
1; 1704; 5115; 5; 8538; 3423 
1; 1705; 5118; 5; 8543; 3425 
1; 1706; 5121; 5; 8548; 3427 
1; 1707; 5124; 5; 8553; 3429 
1; 1708; 5127; 5; 8558; 3431 
1; 1709; 5130; 5; 8563; 3433 
1; 1710; 5133; 5; 8568; 3435 
1; 1711; 5136; 5; 8573; 3437 
1; 1712; 5139; 5; 8578; 3439 
1; 1713; 5142; 5; 8583; 3441 
1; 1714; 5145; 5; 8588; 3443 
1; 1715; 5148; 5; 8593; 3445 
1; 1716; 5151; 5; 8598; 3447 
1; 1717; 5154; 5; 8603; 3449 
1; 1718; 5157; 5; 8608; 3451 
1; 1719; 5160; 5; 8613; 3453 
1; 1720; 5163; 5; 8618; 3455 
1; 1721; 5166; 5; 8623; 3457 
1; 1722; 5169; 5; 8628; 3459 
1; 1723; 5172; 5; 8633; 3461 
1; 1724; 5175; 5; 8638; 3463 
1; 1725; 5178; 5; 8643; 3465 
1; 1726; 5181; 5; 8648; 3467 
1; 1727; 5184; 5; 8653; 3469 
1; 1728; 5187; 5; 8658; 3471 
1; 1729; 5190; 5; 8663; 3473 
1; 1730; 5193; 5; 8668; 3475 
1; 1731; 5196; 5; 8673; 3477 
1; 1732; 5199; 5; 8678; 3479 
1; 1733; 5202; 5; 8683; 3481 
1; 1734; 5205; 5; 8688; 3483 
1; 1735; 5208; 5; 8693; 3485 
1; 1736; 5211; 5; 8698; 3487 
1; 1737; 5214; 5; 8703; 3489 
1; 1738; 5217; 5; 8708; 3491 
1; 1739; 5220; 5; 8713; 3493 
1; 1740; 5223; 5; 8718; 3495 
1; 1741; 5226; 5; 8723; 3497 
1; 1742; 5229; 5; 8728; 3499 
1; 1743; 5232; 5; 8733; 3501 
1; 1744; 5235; 5; 8738; 3503 
1; 1745; 5238; 5; 8743; 3505 
1; 1746; 5241; 5; 8748; 3507 
1; 1747; 5244; 5; 8753; 3509 
1; 1748; 5247; 5; 8758; 3511 
1; 1749; 5250; 5; 8763; 3513 
1; 1750; 5253; 5; 8768; 3515 
1; 1751; 5256; 5; 8773; 3517 
1; 1752; 5259; 5; 8778; 3519 
1; 1753; 5262; 5; 8783; 3521 
1; 1754; 5265; 5; 8788; 3523 
1; 1755; 5268; 5; 8793; 3525 
1; 1756; 5271; 5; 8798; 3527 
1; 1757; 5274; 5; 8803; 3529 
1; 1758; 5277; 5; 8808; 3531 
1; 1759; 5280; 5; 8813; 3533 
1; 1760; 5283; 5; 8818; 3535 
1; 1761; 5286; 5; 8823; 3537 
1; 1762; 5289; 5; 8828; 3539 
1; 1763; 5292; 5; 8833; 3541 
1; 1764; 5295; 5; 8838; 3543 
1; 1765; 5298; 5; 8843; 3545 
1; 1766; 5301; 5; 8848; 3547 
1; 1767; 5304; 5; 8853; 3549 
1; 1768; 5307; 5; 8858; 3551 
1; 1769; 5310; 5; 8863; 3553 
1; 1770; 5313; 5; 8868; 3555 
1; 1771; 5316; 5; 8873; 3557 
1; 1772; 5319; 5; 8878; 3559 
1; 1773; 5322; 5; 8883; 3561 
1; 1774; 5325; 5; 8888; 3563 
1; 1775; 5328; 5; 8893; 3565 
1; 1776; 5331; 5; 8898; 3567 
1; 1777; 5334; 5; 8903; 3569 
1; 1778; 5337; 5; 8908; 3571 
1; 1779; 5340; 5; 8913; 3573 
1; 1780; 5343; 5; 8918; 3575 
1; 1781; 5346; 5; 8923; 3577 
1; 1782; 5349; 5; 8928; 3579 
1; 1783; 5352; 5; 8933; 3581 
1; 1784; 5355; 5; 8938; 3583 
1; 1785; 5358; 5; 8943; 3585 
1; 1786; 5361; 5; 8948; 3587 
1; 1787; 5364; 5; 8953; 3589 
1; 1788; 5367; 5; 8958; 3591 
1; 1789; 5370; 5; 8963; 3593 
1; 1790; 5373; 5; 8968; 3595 
1; 1791; 5376; 5; 8973; 3597 
1; 1792; 5379; 5; 8978; 3599 
1; 1793; 5382; 5; 8983; 3601 
1; 1794; 5385; 5; 8988; 3603 
1; 1795; 5388; 5; 8993; 3605 
1; 1796; 5391; 5; 8998; 3607 
1; 1797; 5394; 5; 9003; 3609 
1; 1798; 5397; 5; 9008; 3611 
1; 1799; 5400; 5; 9013; 3613 
1; 1800; 5403; 5; 9018; 3615 
1; 1801; 5406; 5; 9023; 3617 
1; 1802; 5409; 5; 9028; 3619 
1; 1803; 5412; 5; 9033; 3621 
1; 1804; 5415; 5; 9038; 3623 
1; 1805; 5418; 5; 9043; 3625 
1; 1806; 5421; 5; 9048; 3627 
1; 1807; 5424; 5; 9053; 3629 
1; 1808; 5427; 5; 9058; 3631 
1; 1809; 5430; 5; 9063; 3633 
1; 1810; 5433; 5; 9068; 3635 
1; 1811; 5436; 5; 9073; 3637 
1; 1812; 5439; 5; 9078; 3639 
1; 1813; 5442; 5; 9083; 3641 
1; 1814; 5445; 5; 9088; 3643 
1; 1815; 5448; 5; 9093; 3645 
1; 1816; 5451; 5; 9098; 3647 
1; 1817; 5454; 5; 9103; 3649 
1; 1818; 5457; 5; 9108; 3651 
1; 1819; 5460; 5; 9113; 3653 
1; 1820; 5463; 5; 9118; 3655 
1; 1821; 5466; 5; 9123; 3657 
1; 1822; 5469; 5; 9128; 3659 
1; 1823; 5472; 5; 9133; 3661 
1; 1824; 5475; 5; 9138; 3663 
1; 1825; 5478; 5; 9143; 3665 
1; 1826; 5481; 5; 9148; 3667 
1; 1827; 5484; 5; 9153; 3669 
1; 1828; 5487; 5; 9158; 3671 
1; 1829; 5490; 5; 9163; 3673 
1; 1830; 5493; 5; 9168; 3675 
1; 1831; 5496; 5; 9173; 3677 
1; 1832; 5499; 5; 9178; 3679 
1; 1833; 5502; 5; 9183; 3681 
1; 1834; 5505; 5; 9188; 3683 
1; 1835; 5508; 5; 9193; 3685 
1; 1836; 5511; 5; 9198; 3687 
1; 1837; 5514; 5; 9203; 3689 
1; 1838; 5517; 5; 9208; 3691 
1; 1839; 5520; 5; 9213; 3693 
1; 1840; 5523; 5; 9218; 3695 
1; 1841; 5526; 5; 9223; 3697 
1; 1842; 5529; 5; 9228; 3699 
1; 1843; 5532; 5; 9233; 3701 
1; 1844; 5535; 5; 9238; 3703 
1; 1845; 5538; 5; 9243; 3705 
1; 1846; 5541; 5; 9248; 3707 
1; 1847; 5544; 5; 9253; 3709 
1; 1848; 5547; 5; 9258; 3711 
1; 1849; 5550; 5; 9263; 3713 
1; 1850; 5553; 5; 9268; 3715 
1; 1851; 5556; 5; 9273; 3717 
1; 1852; 5559; 5; 9278; 3719 
1; 1853; 5562; 5; 9283; 3721 
1; 1854; 5565; 5; 9288; 3723 
1; 1855; 5568; 5; 9293; 3725 
1; 1856; 5571; 5; 9298; 3727 
1; 1857; 5574; 5; 9303; 3729 
1; 1858; 5577; 5; 9308; 3731 
1; 1859; 5580; 5; 9313; 3733 
1; 1860; 5583; 5; 9318; 3735 
1; 1861; 5586; 5; 9323; 3737 
1; 1862; 5589; 5; 9328; 3739 
1; 1863; 5592; 5; 9333; 3741 
1; 1864; 5595; 5; 9338; 3743 
1; 1865; 5598; 5; 9343; 3745 
1; 1866; 5601; 5; 9348; 3747 
1; 1867; 5604; 5; 9353; 3749 
1; 1868; 5607; 5; 9358; 3751 
1; 1869; 5610; 5; 9363; 3753 
1; 1870; 5613; 5; 9368; 3755 
1; 1871; 5616; 5; 9373; 3757 
1; 1872; 5619; 5; 9378; 3759 
1; 1873; 5622; 5; 9383; 3761 
1; 1874; 5625; 5; 9388; 3763 
1; 1875; 5628; 5; 9393; 3765 
1; 1876; 5631; 5; 9398; 3767 
1; 1877; 5634; 5; 9403; 3769 
1; 1878; 5637; 5; 9408; 3771 
1; 1879; 5640; 5; 9413; 3773 
1; 1880; 5643; 5; 9418; 3775 
1; 1881; 5646; 5; 9423; 3777 
1; 1882; 5649; 5; 9428; 3779 
1; 1883; 5652; 5; 9433; 3781 
1; 1884; 5655; 5; 9438; 3783 
1; 1885; 5658; 5; 9443; 3785 
1; 1886; 5661; 5; 9448; 3787 
1; 1887; 5664; 5; 9453; 3789 
1; 1888; 5667; 5; 9458; 3791 
1; 1889; 5670; 5; 9463; 3793 
1; 1890; 5673; 5; 9468; 3795 
1; 1891; 5676; 5; 9473; 3797 
1; 1892; 5679; 5; 9478; 3799 
1; 1893; 5682; 5; 9483; 3801 
1; 1894; 5685; 5; 9488; 3803 
1; 1895; 5688; 5; 9493; 3805 
1; 1896; 5691; 5; 9498; 3807 
1; 1897; 5694; 5; 9503; 3809 
1; 1898; 5697; 5; 9508; 3811 
1; 1899; 5700; 5; 9513; 3813 
1; 1900; 5703; 5; 9518; 3815 
1; 1901; 5706; 5; 9523; 3817 
1; 1902; 5709; 5; 9528; 3819 
1; 1903; 5712; 5; 9533; 3821 
1; 1904; 5715; 5; 9538; 3823 
1; 1905; 5718; 5; 9543; 3825 
1; 1906; 5721; 5; 9548; 3827 
1; 1907; 5724; 5; 9553; 3829 
1; 1908; 5727; 5; 9558; 3831 
1; 1909; 5730; 5; 9563; 3833 
1; 1910; 5733; 5; 9568; 3835 
1; 1911; 5736; 5; 9573; 3837 
1; 1912; 5739; 5; 9578; 3839 
1; 1913; 5742; 5; 9583; 3841 
1; 1914; 5745; 5; 9588; 3843 
1; 1915; 5748; 5; 9593; 3845 
1; 1916; 5751; 5; 9598; 3847 
1; 1917; 5754; 5; 9603; 3849 
1; 1918; 5757; 5; 9608; 3851 
1; 1919; 5760; 5; 9613; 3853 
1; 1920; 5763; 5; 9618; 3855 
1; 1921; 5766; 5; 9623; 3857 
1; 1922; 5769; 5; 9628; 3859 
1; 1923; 5772; 5; 9633; 3861 
1; 1924; 5775; 5; 9638; 3863 
1; 1925; 5778; 5; 9643; 3865 
1; 1926; 5781; 5; 9648; 3867 
1; 1927; 5784; 5; 9653; 3869 
1; 1928; 5787; 5; 9658; 3871 
1; 1929; 5790; 5; 9663; 3873 
1; 1930; 5793; 5; 9668; 3875 
1; 1931; 5796; 5; 9673; 3877 
1; 1932; 5799; 5; 9678; 3879 
1; 1933; 5802; 5; 9683; 3881 
1; 1934; 5805; 5; 9688; 3883 
1; 1935; 5808; 5; 9693; 3885 
1; 1936; 5811; 5; 9698; 3887 
1; 1937; 5814; 5; 9703; 3889 
1; 1938; 5817; 5; 9708; 3891 
1; 1939; 5820; 5; 9713; 3893 
1; 1940; 5823; 5; 9718; 3895 
1; 1941; 5826; 5; 9723; 3897 
1; 1942; 5829; 5; 9728; 3899 
1; 1943; 5832; 5; 9733; 3901 
1; 1944; 5835; 5; 9738; 3903 
1; 1945; 5838; 5; 9743; 3905 
1; 1946; 5841; 5; 9748; 3907 
1; 1947; 5844; 5; 9753; 3909 
1; 1948; 5847; 5; 9758; 3911 
1; 1949; 5850; 5; 9763; 3913 
1; 1950; 5853; 5; 9768; 3915 
1; 1951; 5856; 5; 9773; 3917 
1; 1952; 5859; 5; 9778; 3919 
1; 1953; 5862; 5; 9783; 3921 
1; 1954; 5865; 5; 9788; 3923 
1; 1955; 5868; 5; 9793; 3925 
1; 1956; 5871; 5; 9798; 3927 
1; 1957; 5874; 5; 9803; 3929 
1; 1958; 5877; 5; 9808; 3931 
1; 1959; 5880; 5; 9813; 3933 
1; 1960; 5883; 5; 9818; 3935 
1; 1961; 5886; 5; 9823; 3937 
1; 1962; 5889; 5; 9828; 3939 
1; 1963; 5892; 5; 9833; 3941 
1; 1964; 5895; 5; 9838; 3943 
1; 1965; 5898; 5; 9843; 3945 
1; 1966; 5901; 5; 9848; 3947 
1; 1967; 5904; 5; 9853; 3949 
1; 1968; 5907; 5; 9858; 3951 
1; 1969; 5910; 5; 9863; 3953 
1; 1970; 5913; 5; 9868; 3955 
1; 1971; 5916; 5; 9873; 3957 
1; 1972; 5919; 5; 9878; 3959 
1; 1973; 5922; 5; 9883; 3961 
1; 1974; 5925; 5; 9888; 3963 
1; 1975; 5928; 5; 9893; 3965 
1; 1976; 5931; 5; 9898; 3967 
1; 1977; 5934; 5; 9903; 3969 
1; 1978; 5937; 5; 9908; 3971 
1; 1979; 5940; 5; 9913; 3973 
1; 1980; 5943; 5; 9918; 3975 
1; 1981; 5946; 5; 9923; 3977 
1; 1982; 5949; 5; 9928; 3979 
1; 1983; 5952; 5; 9933; 3981 
1; 1984; 5955; 5; 9938; 3983 
1; 1985; 5958; 5; 9943; 3985 
1; 1986; 5961; 5; 9948; 3987 
1; 1987; 5964; 5; 9953; 3989 
1; 1988; 5967; 5; 9958; 3991 
1; 1989; 5970; 5; 9963; 3993 
1; 1990; 5973; 5; 9968; 3995 
1; 1991; 5976; 5; 9973; 3997 
1; 1992; 5979; 5; 9978; 3999 
1; 1993; 5982; 5; 9983; 4001 
1; 1994; 5985; 5; 9988; 4003 
1; 1995; 5988; 5; 9993; 4005 
1; 1996; 5991; 5; 9998; 4007 
1; 1997; 5994; 5; 10003; 4009 
1; 1998; 5997; 5; 10008; 4011 
1; 1999; 6000; 5; 10013; 4013 
1; 2000; 6003; 5; 10018; 4015 
