Grupo; Processo; Inst. Chegada; Tempo de Servi√ßo; Inst. Atendimento; Tempo Perm. Fila 
Grupo 1 
1; 1; 6; 5; 6; 0 
1; 2; 9; 5; 11; 2 
1; 3; 12; 5; 16; 4 
1; 4; 15; 5; 21; 6 
1; 5; 18; 5; 26; 8 
1; 6; 21; 5; 31; 10 
1; 7; 24; 5; 36; 12 
1; 8; 27; 5; 56; 29 
1; 9; 30; 5; 61; 31 
1; 10; 33; 5; 66; 33 
1; 11; 36; 5; 71; 35 
1; 12; 39; 5; 76; 37 
1; 13; 42; 5; 81; 39 
1; 14; 45; 5; 86; 41 
1; 15; 48; 5; 91; 43 
1; 16; 51; 5; 96; 45 
1; 17; 54; 5; 101; 47 
1; 18; 57; 5; 106; 49 
1; 19; 60; 5; 111; 51 
1; 20; 63; 5; 116; 53 
1; 21; 66; 5; 121; 55 
1; 22; 69; 5; 126; 57 
1; 23; 72; 5; 131; 59 
1; 24; 75; 5; 136; 61 
1; 25; 78; 5; 141; 63 
1; 26; 81; 5; 146; 65 
1; 27; 84; 5; 151; 67 
1; 28; 87; 5; 156; 69 
1; 29; 90; 5; 161; 71 
1; 30; 93; 5; 166; 73 
1; 31; 96; 5; 171; 75 
1; 32; 99; 5; 176; 77 
1; 33; 102; 5; 181; 79 
1; 34; 105; 5; 186; 81 
1; 35; 108; 5; 191; 83 
1; 36; 111; 5; 196; 85 
1; 37; 114; 5; 201; 87 
1; 38; 117; 5; 206; 89 
1; 39; 120; 5; 211; 91 
1; 40; 123; 5; 216; 93 
1; 41; 126; 5; 221; 95 
1; 42; 129; 5; 226; 97 
1; 43; 132; 5; 231; 99 
1; 44; 135; 5; 236; 101 
1; 45; 138; 5; 241; 103 
1; 46; 141; 5; 246; 105 
1; 47; 144; 5; 251; 107 
1; 48; 147; 5; 256; 109 
1; 49; 150; 5; 261; 111 
1; 50; 153; 5; 266; 113 
1; 51; 156; 5; 271; 115 
1; 52; 159; 5; 276; 117 
1; 53; 162; 5; 281; 119 
1; 54; 165; 5; 286; 121 
1; 55; 168; 5; 291; 123 
1; 56; 171; 5; 296; 125 
1; 57; 174; 5; 301; 127 
1; 58; 177; 5; 306; 129 
1; 59; 180; 5; 311; 131 
1; 60; 183; 5; 316; 133 
1; 61; 186; 5; 321; 135 
1; 62; 189; 5; 326; 137 
1; 63; 192; 5; 331; 139 
1; 64; 195; 5; 336; 141 
1; 65; 198; 5; 341; 143 
1; 66; 201; 5; 346; 145 
1; 67; 204; 5; 351; 147 
1; 68; 207; 5; 356; 149 
1; 69; 210; 5; 361; 151 
1; 70; 213; 5; 366; 153 
1; 71; 216; 5; 371; 155 
1; 72; 219; 5; 376; 157 
1; 73; 222; 5; 381; 159 
1; 74; 225; 5; 386; 161 
1; 75; 228; 5; 391; 163 
1; 76; 231; 5; 396; 165 
1; 77; 234; 5; 401; 167 
1; 78; 237; 5; 406; 169 
1; 79; 240; 5; 411; 171 
1; 80; 243; 5; 416; 173 
1; 81; 246; 5; 421; 175 
1; 82; 249; 5; 426; 177 
1; 83; 252; 5; 431; 179 
1; 84; 255; 5; 436; 181 
1; 85; 258; 5; 441; 183 
1; 86; 261; 5; 446; 185 
1; 87; 264; 5; 451; 187 
1; 88; 267; 5; 456; 189 
1; 89; 270; 5; 461; 191 
1; 90; 273; 5; 466; 193 
1; 91; 276; 5; 471; 195 
1; 92; 279; 5; 476; 197 
1; 93; 282; 5; 481; 199 
1; 94; 285; 5; 486; 201 
1; 95; 288; 5; 491; 203 
1; 96; 291; 5; 496; 205 
1; 97; 294; 5; 501; 207 
1; 98; 297; 5; 506; 209 
1; 99; 300; 5; 511; 211 
1; 100; 303; 5; 516; 213 
1; 101; 306; 5; 521; 215 
1; 102; 309; 5; 526; 217 
1; 103; 312; 5; 531; 219 
1; 104; 315; 5; 536; 221 
1; 105; 318; 5; 541; 223 
1; 106; 321; 5; 546; 225 
1; 107; 324; 5; 551; 227 
1; 108; 327; 5; 556; 229 
1; 109; 330; 5; 561; 231 
1; 110; 333; 5; 566; 233 
1; 111; 336; 5; 571; 235 
1; 112; 339; 5; 576; 237 
1; 113; 342; 5; 581; 239 
1; 114; 345; 5; 586; 241 
1; 115; 348; 5; 591; 243 
1; 116; 351; 5; 596; 245 
1; 117; 354; 5; 601; 247 
1; 118; 357; 5; 606; 249 
1; 119; 360; 5; 611; 251 
1; 120; 363; 5; 616; 253 
1; 121; 366; 5; 621; 255 
1; 122; 369; 5; 626; 257 
1; 123; 372; 5; 631; 259 
1; 124; 375; 5; 636; 261 
1; 125; 378; 5; 641; 263 
1; 126; 381; 5; 646; 265 
1; 127; 384; 5; 651; 267 
1; 128; 387; 5; 656; 269 
1; 129; 390; 5; 661; 271 
1; 130; 393; 5; 666; 273 
1; 131; 396; 5; 671; 275 
1; 132; 399; 5; 676; 277 
1; 133; 402; 5; 681; 279 
1; 134; 405; 5; 686; 281 
1; 135; 408; 5; 691; 283 
1; 136; 411; 5; 696; 285 
1; 137; 414; 5; 701; 287 
1; 138; 417; 5; 706; 289 
1; 139; 420; 5; 711; 291 
1; 140; 423; 5; 716; 293 
1; 141; 426; 5; 721; 295 
1; 142; 429; 5; 726; 297 
1; 143; 432; 5; 731; 299 
1; 144; 435; 5; 736; 301 
1; 145; 438; 5; 741; 303 
1; 146; 441; 5; 746; 305 
1; 147; 444; 5; 751; 307 
1; 148; 447; 5; 756; 309 
1; 149; 450; 5; 761; 311 
1; 150; 453; 5; 766; 313 
1; 151; 456; 5; 771; 315 
1; 152; 459; 5; 776; 317 
1; 153; 462; 5; 781; 319 
1; 154; 465; 5; 786; 321 
1; 155; 468; 5; 791; 323 
1; 156; 471; 5; 796; 325 
1; 157; 474; 5; 801; 327 
1; 158; 477; 5; 806; 329 
1; 159; 480; 5; 811; 331 
1; 160; 483; 5; 816; 333 
1; 161; 486; 5; 821; 335 
1; 162; 489; 5; 826; 337 
1; 163; 492; 5; 831; 339 
1; 164; 495; 5; 836; 341 
1; 165; 498; 5; 841; 343 
1; 166; 501; 5; 846; 345 
1; 167; 504; 5; 851; 347 
1; 168; 507; 5; 856; 349 
1; 169; 510; 5; 861; 351 
1; 170; 513; 5; 866; 353 
1; 171; 516; 5; 871; 355 
1; 172; 519; 5; 876; 357 
1; 173; 522; 5; 881; 359 
1; 174; 525; 5; 886; 361 
1; 175; 528; 5; 891; 363 
1; 176; 531; 5; 896; 365 
1; 177; 534; 5; 901; 367 
1; 178; 537; 5; 906; 369 
1; 179; 540; 5; 911; 371 
1; 180; 543; 5; 916; 373 
1; 181; 546; 5; 921; 375 
1; 182; 549; 5; 926; 377 
1; 183; 552; 5; 931; 379 
1; 184; 555; 5; 936; 381 
1; 185; 558; 5; 941; 383 
1; 186; 561; 5; 946; 385 
1; 187; 564; 5; 951; 387 
1; 188; 567; 5; 956; 389 
1; 189; 570; 5; 961; 391 
1; 190; 573; 5; 966; 393 
1; 191; 576; 5; 971; 395 
1; 192; 579; 5; 976; 397 
1; 193; 582; 5; 981; 399 
1; 194; 585; 5; 986; 401 
1; 195; 588; 5; 991; 403 
1; 196; 591; 5; 996; 405 
1; 197; 594; 5; 1001; 407 
1; 198; 597; 5; 1006; 409 
1; 199; 600; 5; 1011; 411 
1; 200; 603; 5; 1016; 413 
1; 201; 606; 5; 1021; 415 
1; 202; 609; 5; 1026; 417 
1; 203; 612; 5; 1031; 419 
1; 204; 615; 5; 1036; 421 
1; 205; 618; 5; 1041; 423 
1; 206; 621; 5; 1046; 425 
1; 207; 624; 5; 1051; 427 
1; 208; 627; 5; 1056; 429 
1; 209; 630; 5; 1061; 431 
1; 210; 633; 5; 1066; 433 
1; 211; 636; 5; 1071; 435 
1; 212; 639; 5; 1076; 437 
1; 213; 642; 5; 1081; 439 
1; 214; 645; 5; 1086; 441 
1; 215; 648; 5; 1091; 443 
1; 216; 651; 5; 1096; 445 
1; 217; 654; 5; 1101; 447 
1; 218; 657; 5; 1106; 449 
1; 219; 660; 5; 1111; 451 
1; 220; 663; 5; 1116; 453 
1; 221; 666; 5; 1121; 455 
1; 222; 669; 5; 1126; 457 
1; 223; 672; 5; 1131; 459 
1; 224; 675; 5; 1136; 461 
1; 225; 678; 5; 1141; 463 
1; 226; 681; 5; 1146; 465 
1; 227; 684; 5; 1151; 467 
1; 228; 687; 5; 1156; 469 
1; 229; 690; 5; 1161; 471 
1; 230; 693; 5; 1166; 473 
1; 231; 696; 5; 1171; 475 
1; 232; 699; 5; 1176; 477 
1; 233; 702; 5; 1181; 479 
1; 234; 705; 5; 1186; 481 
1; 235; 708; 5; 1191; 483 
1; 236; 711; 5; 1196; 485 
1; 237; 714; 5; 1201; 487 
1; 238; 717; 5; 1206; 489 
1; 239; 720; 5; 1211; 491 
1; 240; 723; 5; 1216; 493 
1; 241; 726; 5; 1221; 495 
1; 242; 729; 5; 1226; 497 
1; 243; 732; 5; 1231; 499 
1; 244; 735; 5; 1236; 501 
1; 245; 738; 5; 1241; 503 
1; 246; 741; 5; 1246; 505 
1; 247; 744; 5; 1251; 507 
1; 248; 747; 5; 1256; 509 
1; 249; 750; 5; 1261; 511 
1; 250; 753; 5; 1266; 513 
1; 251; 756; 5; 1271; 515 
1; 252; 759; 5; 1276; 517 
1; 253; 762; 5; 1281; 519 
1; 254; 765; 5; 1286; 521 
1; 255; 768; 5; 1291; 523 
1; 256; 771; 5; 1296; 525 
1; 257; 774; 5; 1301; 527 
1; 258; 777; 5; 1306; 529 
1; 259; 780; 5; 1311; 531 
1; 260; 783; 5; 1316; 533 
1; 261; 786; 5; 1321; 535 
1; 262; 789; 5; 1326; 537 
1; 263; 792; 5; 1331; 539 
1; 264; 795; 5; 1336; 541 
1; 265; 798; 5; 1341; 543 
1; 266; 801; 5; 1346; 545 
1; 267; 804; 5; 1351; 547 
1; 268; 807; 5; 1356; 549 
1; 269; 810; 5; 1361; 551 
1; 270; 813; 5; 1366; 553 
1; 271; 816; 5; 1371; 555 
1; 272; 819; 5; 1376; 557 
1; 273; 822; 5; 1381; 559 
1; 274; 825; 5; 1386; 561 
1; 275; 828; 5; 1391; 563 
1; 276; 831; 5; 1396; 565 
1; 277; 834; 5; 1401; 567 
1; 278; 837; 5; 1406; 569 
1; 279; 840; 5; 1411; 571 
1; 280; 843; 5; 1416; 573 
1; 281; 846; 5; 1421; 575 
1; 282; 849; 5; 1426; 577 
1; 283; 852; 5; 1431; 579 
1; 284; 855; 5; 1436; 581 
1; 285; 858; 5; 1441; 583 
1; 286; 861; 5; 1446; 585 
1; 287; 864; 5; 1451; 587 
1; 288; 867; 5; 1456; 589 
1; 289; 870; 5; 1461; 591 
1; 290; 873; 5; 1466; 593 
1; 291; 876; 5; 1471; 595 
1; 292; 879; 5; 1476; 597 
1; 293; 882; 5; 1481; 599 
1; 294; 885; 5; 1486; 601 
1; 295; 888; 5; 1491; 603 
1; 296; 891; 5; 1496; 605 
1; 297; 894; 5; 1501; 607 
1; 298; 897; 5; 1506; 609 
1; 299; 900; 5; 1511; 611 
1; 300; 903; 5; 1516; 613 
1; 301; 906; 5; 1521; 615 
1; 302; 909; 5; 1526; 617 
1; 303; 912; 5; 1531; 619 
1; 304; 915; 5; 1536; 621 
1; 305; 918; 5; 1541; 623 
1; 306; 921; 5; 1546; 625 
1; 307; 924; 5; 1551; 627 
1; 308; 927; 5; 1556; 629 
1; 309; 930; 5; 1561; 631 
1; 310; 933; 5; 1566; 633 
1; 311; 936; 5; 1571; 635 
1; 312; 939; 5; 1576; 637 
1; 313; 942; 5; 1581; 639 
1; 314; 945; 5; 1586; 641 
1; 315; 948; 5; 1591; 643 
1; 316; 951; 5; 1596; 645 
1; 317; 954; 5; 1601; 647 
1; 318; 957; 5; 1606; 649 
1; 319; 960; 5; 1611; 651 
1; 320; 963; 5; 1616; 653 
1; 321; 966; 5; 1621; 655 
1; 322; 969; 5; 1626; 657 
1; 323; 972; 5; 1631; 659 
1; 324; 975; 5; 1636; 661 
1; 325; 978; 5; 1641; 663 
1; 326; 981; 5; 1646; 665 
1; 327; 984; 5; 1651; 667 
1; 328; 987; 5; 1656; 669 
1; 329; 990; 5; 1661; 671 
1; 330; 993; 5; 1666; 673 
1; 331; 996; 5; 1671; 675 
1; 332; 999; 5; 1676; 677 
1; 333; 1002; 5; 1681; 679 
1; 334; 1005; 5; 1686; 681 
1; 335; 1008; 5; 1691; 683 
1; 336; 1011; 5; 1696; 685 
1; 337; 1014; 5; 1701; 687 
1; 338; 1017; 5; 1706; 689 
1; 339; 1020; 5; 1711; 691 
1; 340; 1023; 5; 1716; 693 
1; 341; 1026; 5; 1721; 695 
1; 342; 1029; 5; 1726; 697 
1; 343; 1032; 5; 1731; 699 
1; 344; 1035; 5; 1736; 701 
1; 345; 1038; 5; 1741; 703 
1; 346; 1041; 5; 1746; 705 
1; 347; 1044; 5; 1751; 707 
1; 348; 1047; 5; 1756; 709 
1; 349; 1050; 5; 1761; 711 
1; 350; 1053; 5; 1766; 713 
1; 351; 1056; 5; 1771; 715 
1; 352; 1059; 5; 1776; 717 
1; 353; 1062; 5; 1781; 719 
1; 354; 1065; 5; 1786; 721 
1; 355; 1068; 5; 1791; 723 
1; 356; 1071; 5; 1796; 725 
1; 357; 1074; 5; 1801; 727 
1; 358; 1077; 5; 1806; 729 
1; 359; 1080; 5; 1811; 731 
1; 360; 1083; 5; 1816; 733 
1; 361; 1086; 5; 1821; 735 
1; 362; 1089; 5; 1826; 737 
1; 363; 1092; 5; 1831; 739 
1; 364; 1095; 5; 1836; 741 
1; 365; 1098; 5; 1841; 743 
1; 366; 1101; 5; 1846; 745 
1; 367; 1104; 5; 1851; 747 
1; 368; 1107; 5; 1856; 749 
1; 369; 1110; 5; 1861; 751 
1; 370; 1113; 5; 1866; 753 
1; 371; 1116; 5; 1871; 755 
1; 372; 1119; 5; 1876; 757 
1; 373; 1122; 5; 1881; 759 
1; 374; 1125; 5; 1886; 761 
1; 375; 1128; 5; 1891; 763 
1; 376; 1131; 5; 1896; 765 
1; 377; 1134; 5; 1901; 767 
1; 378; 1137; 5; 1906; 769 
1; 379; 1140; 5; 1911; 771 
1; 380; 1143; 5; 1916; 773 
1; 381; 1146; 5; 1921; 775 
1; 382; 1149; 5; 1926; 777 
1; 383; 1152; 5; 1931; 779 
1; 384; 1155; 5; 1936; 781 
1; 385; 1158; 5; 1941; 783 
1; 386; 1161; 5; 1946; 785 
1; 387; 1164; 5; 1951; 787 
1; 388; 1167; 5; 1956; 789 
1; 389; 1170; 5; 1961; 791 
1; 390; 1173; 5; 1966; 793 
1; 391; 1176; 5; 1971; 795 
1; 392; 1179; 5; 1976; 797 
1; 393; 1182; 5; 1981; 799 
1; 394; 1185; 5; 1986; 801 
1; 395; 1188; 5; 1991; 803 
1; 396; 1191; 5; 1996; 805 
1; 397; 1194; 5; 2001; 807 
1; 398; 1197; 5; 2006; 809 
1; 399; 1200; 5; 2011; 811 
1; 400; 1203; 5; 2016; 813 
1; 401; 1206; 5; 2021; 815 
1; 402; 1209; 5; 2026; 817 
1; 403; 1212; 5; 2031; 819 
1; 404; 1215; 5; 2036; 821 
1; 405; 1218; 5; 2041; 823 
1; 406; 1221; 5; 2046; 825 
1; 407; 1224; 5; 2051; 827 
1; 408; 1227; 5; 2056; 829 
1; 409; 1230; 5; 2061; 831 
1; 410; 1233; 5; 2066; 833 
1; 411; 1236; 5; 2071; 835 
1; 412; 1239; 5; 2076; 837 
1; 413; 1242; 5; 2081; 839 
1; 414; 1245; 5; 2086; 841 
1; 415; 1248; 5; 2091; 843 
1; 416; 1251; 5; 2096; 845 
1; 417; 1254; 5; 2101; 847 
1; 418; 1257; 5; 2106; 849 
1; 419; 1260; 5; 2111; 851 
1; 420; 1263; 5; 2116; 853 
1; 421; 1266; 5; 2121; 855 
1; 422; 1269; 5; 2126; 857 
1; 423; 1272; 5; 2131; 859 
1; 424; 1275; 5; 2136; 861 
1; 425; 1278; 5; 2141; 863 
1; 426; 1281; 5; 2146; 865 
1; 427; 1284; 5; 2151; 867 
1; 428; 1287; 5; 2156; 869 
1; 429; 1290; 5; 2161; 871 
1; 430; 1293; 5; 2166; 873 
1; 431; 1296; 5; 2171; 875 
1; 432; 1299; 5; 2176; 877 
1; 433; 1302; 5; 2181; 879 
1; 434; 1305; 5; 2186; 881 
1; 435; 1308; 5; 2191; 883 
1; 436; 1311; 5; 2196; 885 
1; 437; 1314; 5; 2201; 887 
1; 438; 1317; 5; 2206; 889 
1; 439; 1320; 5; 2211; 891 
1; 440; 1323; 5; 2216; 893 
1; 441; 1326; 5; 2221; 895 
1; 442; 1329; 5; 2226; 897 
1; 443; 1332; 5; 2231; 899 
1; 444; 1335; 5; 2236; 901 
1; 445; 1338; 5; 2241; 903 
1; 446; 1341; 5; 2246; 905 
1; 447; 1344; 5; 2251; 907 
1; 448; 1347; 5; 2256; 909 
1; 449; 1350; 5; 2261; 911 
1; 450; 1353; 5; 2266; 913 
1; 451; 1356; 5; 2271; 915 
1; 452; 1359; 5; 2276; 917 
1; 453; 1362; 5; 2281; 919 
1; 454; 1365; 5; 2286; 921 
1; 455; 1368; 5; 2291; 923 
1; 456; 1371; 5; 2296; 925 
1; 457; 1374; 5; 2301; 927 
1; 458; 1377; 5; 2306; 929 
1; 459; 1380; 5; 2311; 931 
1; 460; 1383; 5; 2316; 933 
1; 461; 1386; 5; 2321; 935 
1; 462; 1389; 5; 2326; 937 
1; 463; 1392; 5; 2331; 939 
1; 464; 1395; 5; 2336; 941 
1; 465; 1398; 5; 2341; 943 
1; 466; 1401; 5; 2346; 945 
1; 467; 1404; 5; 2351; 947 
1; 468; 1407; 5; 2356; 949 
1; 469; 1410; 5; 2361; 951 
1; 470; 1413; 5; 2366; 953 
1; 471; 1416; 5; 2371; 955 
1; 472; 1419; 5; 2376; 957 
1; 473; 1422; 5; 2381; 959 
1; 474; 1425; 5; 2386; 961 
1; 475; 1428; 5; 2391; 963 
1; 476; 1431; 5; 2396; 965 
1; 477; 1434; 5; 2401; 967 
1; 478; 1437; 5; 2406; 969 
1; 479; 1440; 5; 2411; 971 
1; 480; 1443; 5; 2416; 973 
1; 481; 1446; 5; 2421; 975 
1; 482; 1449; 5; 2426; 977 
1; 483; 1452; 5; 2431; 979 
1; 484; 1455; 5; 2436; 981 
1; 485; 1458; 5; 2441; 983 
1; 486; 1461; 5; 2446; 985 
1; 487; 1464; 5; 2451; 987 
1; 488; 1467; 5; 2456; 989 
1; 489; 1470; 5; 2461; 991 
1; 490; 1473; 5; 2466; 993 
1; 491; 1476; 5; 2471; 995 
1; 492; 1479; 5; 2476; 997 
1; 493; 1482; 5; 2481; 999 
1; 494; 1485; 5; 2486; 1001 
1; 495; 1488; 5; 2491; 1003 
1; 496; 1491; 5; 2496; 1005 
1; 497; 1494; 5; 2501; 1007 
1; 498; 1497; 5; 2506; 1009 
1; 499; 1500; 5; 2511; 1011 
1; 500; 1503; 5; 2516; 1013 
1; 501; 1506; 5; 2521; 1015 
1; 502; 1509; 5; 2526; 1017 
1; 503; 1512; 5; 2531; 1019 
1; 504; 1515; 5; 2536; 1021 
1; 505; 1518; 5; 2541; 1023 
1; 506; 1521; 5; 2546; 1025 
1; 507; 1524; 5; 2551; 1027 
1; 508; 1527; 5; 2556; 1029 
1; 509; 1530; 5; 2561; 1031 
1; 510; 1533; 5; 2566; 1033 
1; 511; 1536; 5; 2571; 1035 
1; 512; 1539; 5; 2576; 1037 
1; 513; 1542; 5; 2581; 1039 
1; 514; 1545; 5; 2586; 1041 
1; 515; 1548; 5; 2591; 1043 
1; 516; 1551; 5; 2596; 1045 
1; 517; 1554; 5; 2601; 1047 
1; 518; 1557; 5; 2606; 1049 
1; 519; 1560; 5; 2611; 1051 
1; 520; 1563; 5; 2616; 1053 
1; 521; 1566; 5; 2621; 1055 
1; 522; 1569; 5; 2626; 1057 
1; 523; 1572; 5; 2631; 1059 
1; 524; 1575; 5; 2636; 1061 
1; 525; 1578; 5; 2641; 1063 
1; 526; 1581; 5; 2646; 1065 
1; 527; 1584; 5; 2651; 1067 
1; 528; 1587; 5; 2656; 1069 
1; 529; 1590; 5; 2661; 1071 
1; 530; 1593; 5; 2666; 1073 
1; 531; 1596; 5; 2671; 1075 
1; 532; 1599; 5; 2676; 1077 
1; 533; 1602; 5; 2681; 1079 
1; 534; 1605; 5; 2686; 1081 
1; 535; 1608; 5; 2691; 1083 
1; 536; 1611; 5; 2696; 1085 
1; 537; 1614; 5; 2701; 1087 
1; 538; 1617; 5; 2706; 1089 
1; 539; 1620; 5; 2711; 1091 
1; 540; 1623; 5; 2716; 1093 
1; 541; 1626; 5; 2721; 1095 
1; 542; 1629; 5; 2726; 1097 
1; 543; 1632; 5; 2731; 1099 
1; 544; 1635; 5; 2736; 1101 
1; 545; 1638; 5; 2741; 1103 
1; 546; 1641; 5; 2746; 1105 
1; 547; 1644; 5; 2751; 1107 
1; 548; 1647; 5; 2756; 1109 
1; 549; 1650; 5; 2761; 1111 
1; 550; 1653; 5; 2766; 1113 
1; 551; 1656; 5; 2771; 1115 
1; 552; 1659; 5; 2776; 1117 
1; 553; 1662; 5; 2781; 1119 
1; 554; 1665; 5; 2786; 1121 
1; 555; 1668; 5; 2791; 1123 
1; 556; 1671; 5; 2796; 1125 
1; 557; 1674; 5; 2801; 1127 
1; 558; 1677; 5; 2806; 1129 
1; 559; 1680; 5; 2811; 1131 
1; 560; 1683; 5; 2816; 1133 
1; 561; 1686; 5; 2821; 1135 
1; 562; 1689; 5; 2826; 1137 
1; 563; 1692; 5; 2831; 1139 
1; 564; 1695; 5; 2836; 1141 
1; 565; 1698; 5; 2841; 1143 
1; 566; 1701; 5; 2846; 1145 
1; 567; 1704; 5; 2851; 1147 
1; 568; 1707; 5; 2856; 1149 
1; 569; 1710; 5; 2861; 1151 
1; 570; 1713; 5; 2866; 1153 
1; 571; 1716; 5; 2871; 1155 
1; 572; 1719; 5; 2876; 1157 
1; 573; 1722; 5; 2881; 1159 
1; 574; 1725; 5; 2886; 1161 
1; 575; 1728; 5; 2891; 1163 
1; 576; 1731; 5; 2896; 1165 
1; 577; 1734; 5; 2901; 1167 
1; 578; 1737; 5; 2906; 1169 
1; 579; 1740; 5; 2911; 1171 
1; 580; 1743; 5; 2916; 1173 
1; 581; 1746; 5; 2921; 1175 
1; 582; 1749; 5; 2926; 1177 
1; 583; 1752; 5; 2931; 1179 
1; 584; 1755; 5; 2936; 1181 
1; 585; 1758; 5; 2941; 1183 
1; 586; 1761; 5; 2946; 1185 
1; 587; 1764; 5; 2951; 1187 
1; 588; 1767; 5; 2956; 1189 
1; 589; 1770; 5; 2961; 1191 
1; 590; 1773; 5; 2966; 1193 
1; 591; 1776; 5; 2971; 1195 
1; 592; 1779; 5; 2976; 1197 
1; 593; 1782; 5; 2981; 1199 
1; 594; 1785; 5; 2986; 1201 
1; 595; 1788; 5; 2991; 1203 
1; 596; 1791; 5; 2996; 1205 
1; 597; 1794; 5; 3001; 1207 
1; 598; 1797; 5; 3006; 1209 
1; 599; 1800; 5; 3011; 1211 
1; 600; 1803; 5; 3016; 1213 
1; 601; 1806; 5; 3021; 1215 
1; 602; 1809; 5; 3026; 1217 
1; 603; 1812; 5; 3031; 1219 
1; 604; 1815; 5; 3036; 1221 
1; 605; 1818; 5; 3041; 1223 
1; 606; 1821; 5; 3046; 1225 
1; 607; 1824; 5; 3051; 1227 
1; 608; 1827; 5; 3056; 1229 
1; 609; 1830; 5; 3061; 1231 
1; 610; 1833; 5; 3066; 1233 
1; 611; 1836; 5; 3071; 1235 
1; 612; 1839; 5; 3076; 1237 
1; 613; 1842; 5; 3081; 1239 
1; 614; 1845; 5; 3086; 1241 
1; 615; 1848; 5; 3091; 1243 
1; 616; 1851; 5; 3096; 1245 
1; 617; 1854; 5; 3101; 1247 
1; 618; 1857; 5; 3106; 1249 
1; 619; 1860; 5; 3111; 1251 
1; 620; 1863; 5; 3116; 1253 
1; 621; 1866; 5; 3121; 1255 
1; 622; 1869; 5; 3126; 1257 
1; 623; 1872; 5; 3131; 1259 
1; 624; 1875; 5; 3136; 1261 
1; 625; 1878; 5; 3141; 1263 
1; 626; 1881; 5; 3146; 1265 
1; 627; 1884; 5; 3151; 1267 
1; 628; 1887; 5; 3156; 1269 
1; 629; 1890; 5; 3161; 1271 
1; 630; 1893; 5; 3166; 1273 
1; 631; 1896; 5; 3171; 1275 
1; 632; 1899; 5; 3176; 1277 
1; 633; 1902; 5; 3181; 1279 
1; 634; 1905; 5; 3186; 1281 
1; 635; 1908; 5; 3191; 1283 
1; 636; 1911; 5; 3196; 1285 
1; 637; 1914; 5; 3201; 1287 
1; 638; 1917; 5; 3206; 1289 
1; 639; 1920; 5; 3211; 1291 
1; 640; 1923; 5; 3216; 1293 
1; 641; 1926; 5; 3221; 1295 
1; 642; 1929; 5; 3226; 1297 
1; 643; 1932; 5; 3231; 1299 
1; 644; 1935; 5; 3236; 1301 
1; 645; 1938; 5; 3241; 1303 
1; 646; 1941; 5; 3246; 1305 
1; 647; 1944; 5; 3251; 1307 
1; 648; 1947; 5; 3256; 1309 
1; 649; 1950; 5; 3261; 1311 
1; 650; 1953; 5; 3266; 1313 
1; 651; 1956; 5; 3271; 1315 
1; 652; 1959; 5; 3276; 1317 
1; 653; 1962; 5; 3281; 1319 
1; 654; 1965; 5; 3286; 1321 
1; 655; 1968; 5; 3291; 1323 
1; 656; 1971; 5; 3296; 1325 
1; 657; 1974; 5; 3301; 1327 
1; 658; 1977; 5; 3306; 1329 
1; 659; 1980; 5; 3311; 1331 
1; 660; 1983; 5; 3316; 1333 
1; 661; 1986; 5; 3321; 1335 
1; 662; 1989; 5; 3326; 1337 
1; 663; 1992; 5; 3331; 1339 
1; 664; 1995; 5; 3336; 1341 
1; 665; 1998; 5; 3341; 1343 
1; 666; 2001; 5; 3346; 1345 
1; 667; 2004; 5; 3351; 1347 
1; 668; 2007; 5; 3356; 1349 
1; 669; 2010; 5; 3361; 1351 
1; 670; 2013; 5; 3366; 1353 
1; 671; 2016; 5; 3371; 1355 
1; 672; 2019; 5; 3376; 1357 
1; 673; 2022; 5; 3381; 1359 
1; 674; 2025; 5; 3386; 1361 
1; 675; 2028; 5; 3391; 1363 
1; 676; 2031; 5; 3396; 1365 
1; 677; 2034; 5; 3401; 1367 
1; 678; 2037; 5; 3406; 1369 
1; 679; 2040; 5; 3411; 1371 
1; 680; 2043; 5; 3416; 1373 
1; 681; 2046; 5; 3421; 1375 
1; 682; 2049; 5; 3426; 1377 
1; 683; 2052; 5; 3431; 1379 
1; 684; 2055; 5; 3436; 1381 
1; 685; 2058; 5; 3441; 1383 
1; 686; 2061; 5; 3446; 1385 
1; 687; 2064; 5; 3451; 1387 
1; 688; 2067; 5; 3456; 1389 
1; 689; 2070; 5; 3461; 1391 
1; 690; 2073; 5; 3466; 1393 
1; 691; 2076; 5; 3471; 1395 
1; 692; 2079; 5; 3476; 1397 
1; 693; 2082; 5; 3481; 1399 
1; 694; 2085; 5; 3486; 1401 
1; 695; 2088; 5; 3491; 1403 
1; 696; 2091; 5; 3496; 1405 
1; 697; 2094; 5; 3501; 1407 
1; 698; 2097; 5; 3506; 1409 
1; 699; 2100; 5; 3511; 1411 
1; 700; 2103; 5; 3516; 1413 
1; 701; 2106; 5; 3521; 1415 
1; 702; 2109; 5; 3526; 1417 
1; 703; 2112; 5; 3531; 1419 
1; 704; 2115; 5; 3536; 1421 
1; 705; 2118; 5; 3541; 1423 
1; 706; 2121; 5; 3546; 1425 
1; 707; 2124; 5; 3551; 1427 
1; 708; 2127; 5; 3556; 1429 
1; 709; 2130; 5; 3561; 1431 
1; 710; 2133; 5; 3566; 1433 
1; 711; 2136; 5; 3571; 1435 
1; 712; 2139; 5; 3576; 1437 
1; 713; 2142; 5; 3581; 1439 
1; 714; 2145; 5; 3586; 1441 
1; 715; 2148; 5; 3591; 1443 
1; 716; 2151; 5; 3596; 1445 
1; 717; 2154; 5; 3601; 1447 
1; 718; 2157; 5; 3606; 1449 
1; 719; 2160; 5; 3611; 1451 
1; 720; 2163; 5; 3616; 1453 
1; 721; 2166; 5; 3621; 1455 
1; 722; 2169; 5; 3626; 1457 
1; 723; 2172; 5; 3631; 1459 
1; 724; 2175; 5; 3636; 1461 
1; 725; 2178; 5; 3641; 1463 
1; 726; 2181; 5; 3646; 1465 
1; 727; 2184; 5; 3651; 1467 
1; 728; 2187; 5; 3656; 1469 
1; 729; 2190; 5; 3661; 1471 
1; 730; 2193; 5; 3666; 1473 
1; 731; 2196; 5; 3671; 1475 
1; 732; 2199; 5; 3676; 1477 
1; 733; 2202; 5; 3681; 1479 
1; 734; 2205; 5; 3686; 1481 
1; 735; 2208; 5; 3691; 1483 
1; 736; 2211; 5; 3696; 1485 
1; 737; 2214; 5; 3701; 1487 
1; 738; 2217; 5; 3706; 1489 
1; 739; 2220; 5; 3711; 1491 
1; 740; 2223; 5; 3716; 1493 
1; 741; 2226; 5; 3721; 1495 
1; 742; 2229; 5; 3726; 1497 
1; 743; 2232; 5; 3731; 1499 
1; 744; 2235; 5; 3736; 1501 
1; 745; 2238; 5; 3741; 1503 
1; 746; 2241; 5; 3746; 1505 
1; 747; 2244; 5; 3751; 1507 
1; 748; 2247; 5; 3756; 1509 
1; 749; 2250; 5; 3761; 1511 
1; 750; 2253; 5; 3766; 1513 
1; 751; 2256; 5; 3771; 1515 
1; 752; 2259; 5; 3776; 1517 
1; 753; 2262; 5; 3781; 1519 
1; 754; 2265; 5; 3786; 1521 
1; 755; 2268; 5; 3791; 1523 
1; 756; 2271; 5; 3796; 1525 
1; 757; 2274; 5; 3801; 1527 
1; 758; 2277; 5; 3806; 1529 
1; 759; 2280; 5; 3811; 1531 
1; 760; 2283; 5; 3816; 1533 
1; 761; 2286; 5; 3821; 1535 
1; 762; 2289; 5; 3826; 1537 
1; 763; 2292; 5; 3831; 1539 
1; 764; 2295; 5; 3836; 1541 
1; 765; 2298; 5; 3841; 1543 
1; 766; 2301; 5; 3846; 1545 
1; 767; 2304; 5; 3851; 1547 
1; 768; 2307; 5; 3856; 1549 
1; 769; 2310; 5; 3861; 1551 
1; 770; 2313; 5; 3866; 1553 
1; 771; 2316; 5; 3871; 1555 
1; 772; 2319; 5; 3876; 1557 
1; 773; 2322; 5; 3881; 1559 
1; 774; 2325; 5; 3886; 1561 
1; 775; 2328; 5; 3891; 1563 
1; 776; 2331; 5; 3896; 1565 
1; 777; 2334; 5; 3901; 1567 
1; 778; 2337; 5; 3906; 1569 
1; 779; 2340; 5; 3911; 1571 
1; 780; 2343; 5; 3916; 1573 
1; 781; 2346; 5; 3921; 1575 
1; 782; 2349; 5; 3926; 1577 
1; 783; 2352; 5; 3931; 1579 
1; 784; 2355; 5; 3936; 1581 
1; 785; 2358; 5; 3941; 1583 
1; 786; 2361; 5; 3946; 1585 
1; 787; 2364; 5; 3951; 1587 
1; 788; 2367; 5; 3956; 1589 
1; 789; 2370; 5; 3961; 1591 
1; 790; 2373; 5; 3966; 1593 
1; 791; 2376; 5; 3971; 1595 
1; 792; 2379; 5; 3976; 1597 
1; 793; 2382; 5; 3981; 1599 
1; 794; 2385; 5; 3986; 1601 
1; 795; 2388; 5; 3991; 1603 
1; 796; 2391; 5; 3996; 1605 
1; 797; 2394; 5; 4001; 1607 
1; 798; 2397; 5; 4006; 1609 
1; 799; 2400; 5; 4011; 1611 
1; 800; 2403; 5; 4016; 1613 
1; 801; 2406; 5; 4021; 1615 
1; 802; 2409; 5; 4026; 1617 
1; 803; 2412; 5; 4031; 1619 
1; 804; 2415; 5; 4036; 1621 
1; 805; 2418; 5; 4041; 1623 
1; 806; 2421; 5; 4046; 1625 
1; 807; 2424; 5; 4051; 1627 
1; 808; 2427; 5; 4056; 1629 
1; 809; 2430; 5; 4061; 1631 
1; 810; 2433; 5; 4066; 1633 
1; 811; 2436; 5; 4071; 1635 
1; 812; 2439; 5; 4076; 1637 
1; 813; 2442; 5; 4081; 1639 
1; 814; 2445; 5; 4086; 1641 
1; 815; 2448; 5; 4091; 1643 
1; 816; 2451; 5; 4096; 1645 
1; 817; 2454; 5; 4101; 1647 
1; 818; 2457; 5; 4106; 1649 
1; 819; 2460; 5; 4111; 1651 
1; 820; 2463; 5; 4116; 1653 
1; 821; 2466; 5; 4121; 1655 
1; 822; 2469; 5; 4126; 1657 
1; 823; 2472; 5; 4131; 1659 
1; 824; 2475; 5; 4136; 1661 
1; 825; 2478; 5; 4141; 1663 
1; 826; 2481; 5; 4146; 1665 
1; 827; 2484; 5; 4151; 1667 
1; 828; 2487; 5; 4156; 1669 
1; 829; 2490; 5; 4161; 1671 
1; 830; 2493; 5; 4166; 1673 
1; 831; 2496; 5; 4171; 1675 
1; 832; 2499; 5; 4176; 1677 
1; 833; 2502; 5; 4181; 1679 
1; 834; 2505; 5; 4186; 1681 
1; 835; 2508; 5; 4191; 1683 
1; 836; 2511; 5; 4196; 1685 
1; 837; 2514; 5; 4201; 1687 
1; 838; 2517; 5; 4206; 1689 
1; 839; 2520; 5; 4211; 1691 
1; 840; 2523; 5; 4216; 1693 
1; 841; 2526; 5; 4221; 1695 
1; 842; 2529; 5; 4226; 1697 
1; 843; 2532; 5; 4231; 1699 
1; 844; 2535; 5; 4236; 1701 
1; 845; 2538; 5; 4241; 1703 
1; 846; 2541; 5; 4246; 1705 
1; 847; 2544; 5; 4251; 1707 
1; 848; 2547; 5; 4256; 1709 
1; 849; 2550; 5; 4261; 1711 
1; 850; 2553; 5; 4266; 1713 
1; 851; 2556; 5; 4271; 1715 
1; 852; 2559; 5; 4276; 1717 
1; 853; 2562; 5; 4281; 1719 
1; 854; 2565; 5; 4286; 1721 
1; 855; 2568; 5; 4291; 1723 
1; 856; 2571; 5; 4296; 1725 
1; 857; 2574; 5; 4301; 1727 
1; 858; 2577; 5; 4306; 1729 
1; 859; 2580; 5; 4311; 1731 
1; 860; 2583; 5; 4316; 1733 
1; 861; 2586; 5; 4321; 1735 
1; 862; 2589; 5; 4326; 1737 
1; 863; 2592; 5; 4331; 1739 
1; 864; 2595; 5; 4336; 1741 
1; 865; 2598; 5; 4341; 1743 
1; 866; 2601; 5; 4346; 1745 
1; 867; 2604; 5; 4351; 1747 
1; 868; 2607; 5; 4356; 1749 
1; 869; 2610; 5; 4361; 1751 
1; 870; 2613; 5; 4366; 1753 
1; 871; 2616; 5; 4371; 1755 
1; 872; 2619; 5; 4376; 1757 
1; 873; 2622; 5; 4381; 1759 
1; 874; 2625; 5; 4386; 1761 
1; 875; 2628; 5; 4391; 1763 
1; 876; 2631; 5; 4396; 1765 
1; 877; 2634; 5; 4401; 1767 
1; 878; 2637; 5; 4406; 1769 
1; 879; 2640; 5; 4411; 1771 
1; 880; 2643; 5; 4416; 1773 
1; 881; 2646; 5; 4421; 1775 
1; 882; 2649; 5; 4426; 1777 
1; 883; 2652; 5; 4431; 1779 
1; 884; 2655; 5; 4436; 1781 
1; 885; 2658; 5; 4441; 1783 
1; 886; 2661; 5; 4446; 1785 
1; 887; 2664; 5; 4451; 1787 
1; 888; 2667; 5; 4456; 1789 
1; 889; 2670; 5; 4461; 1791 
1; 890; 2673; 5; 4466; 1793 
1; 891; 2676; 5; 4471; 1795 
1; 892; 2679; 5; 4476; 1797 
1; 893; 2682; 5; 4481; 1799 
1; 894; 2685; 5; 4486; 1801 
1; 895; 2688; 5; 4491; 1803 
1; 896; 2691; 5; 4496; 1805 
1; 897; 2694; 5; 4501; 1807 
1; 898; 2697; 5; 4506; 1809 
1; 899; 2700; 5; 4511; 1811 
1; 900; 2703; 5; 4516; 1813 
1; 901; 2706; 5; 4521; 1815 
1; 902; 2709; 5; 4526; 1817 
1; 903; 2712; 5; 4531; 1819 
1; 904; 2715; 5; 4536; 1821 
1; 905; 2718; 5; 4541; 1823 
1; 906; 2721; 5; 4546; 1825 
1; 907; 2724; 5; 4551; 1827 
1; 908; 2727; 5; 4556; 1829 
1; 909; 2730; 5; 4561; 1831 
1; 910; 2733; 5; 4566; 1833 
1; 911; 2736; 5; 4571; 1835 
1; 912; 2739; 5; 4576; 1837 
1; 913; 2742; 5; 4581; 1839 
1; 914; 2745; 5; 4586; 1841 
1; 915; 2748; 5; 4591; 1843 
1; 916; 2751; 5; 4596; 1845 
1; 917; 2754; 5; 4601; 1847 
1; 918; 2757; 5; 4606; 1849 
1; 919; 2760; 5; 4611; 1851 
1; 920; 2763; 5; 4616; 1853 
1; 921; 2766; 5; 4621; 1855 
1; 922; 2769; 5; 4626; 1857 
1; 923; 2772; 5; 4631; 1859 
1; 924; 2775; 5; 4636; 1861 
1; 925; 2778; 5; 4641; 1863 
1; 926; 2781; 5; 4646; 1865 
1; 927; 2784; 5; 4651; 1867 
1; 928; 2787; 5; 4656; 1869 
1; 929; 2790; 5; 4661; 1871 
1; 930; 2793; 5; 4666; 1873 
1; 931; 2796; 5; 4671; 1875 
1; 932; 2799; 5; 4676; 1877 
1; 933; 2802; 5; 4681; 1879 
1; 934; 2805; 5; 4686; 1881 
1; 935; 2808; 5; 4691; 1883 
1; 936; 2811; 5; 4696; 1885 
1; 937; 2814; 5; 4701; 1887 
1; 938; 2817; 5; 4706; 1889 
1; 939; 2820; 5; 4711; 1891 
1; 940; 2823; 5; 4716; 1893 
1; 941; 2826; 5; 4721; 1895 
1; 942; 2829; 5; 4726; 1897 
1; 943; 2832; 5; 4731; 1899 
1; 944; 2835; 5; 4736; 1901 
1; 945; 2838; 5; 4741; 1903 
1; 946; 2841; 5; 4746; 1905 
1; 947; 2844; 5; 4751; 1907 
1; 948; 2847; 5; 4756; 1909 
1; 949; 2850; 5; 4761; 1911 
1; 950; 2853; 5; 4766; 1913 
1; 951; 2856; 5; 4771; 1915 
1; 952; 2859; 5; 4776; 1917 
1; 953; 2862; 5; 4781; 1919 
1; 954; 2865; 5; 4786; 1921 
1; 955; 2868; 5; 4791; 1923 
1; 956; 2871; 5; 4796; 1925 
1; 957; 2874; 5; 4801; 1927 
1; 958; 2877; 5; 4806; 1929 
1; 959; 2880; 5; 4811; 1931 
1; 960; 2883; 5; 4816; 1933 
1; 961; 2886; 5; 4821; 1935 
1; 962; 2889; 5; 4826; 1937 
1; 963; 2892; 5; 4831; 1939 
1; 964; 2895; 5; 4836; 1941 
1; 965; 2898; 5; 4841; 1943 
1; 966; 2901; 5; 4846; 1945 
1; 967; 2904; 5; 4851; 1947 
1; 968; 2907; 5; 4856; 1949 
1; 969; 2910; 5; 4861; 1951 
1; 970; 2913; 5; 4866; 1953 
1; 971; 2916; 5; 4871; 1955 
1; 972; 2919; 5; 4876; 1957 
1; 973; 2922; 5; 4881; 1959 
1; 974; 2925; 5; 4886; 1961 
1; 975; 2928; 5; 4891; 1963 
1; 976; 2931; 5; 4896; 1965 
1; 977; 2934; 5; 4901; 1967 
1; 978; 2937; 5; 4906; 1969 
1; 979; 2940; 5; 4911; 1971 
1; 980; 2943; 5; 4916; 1973 
1; 981; 2946; 5; 4921; 1975 
1; 982; 2949; 5; 4926; 1977 
1; 983; 2952; 5; 4931; 1979 
1; 984; 2955; 5; 4936; 1981 
1; 985; 2958; 5; 4941; 1983 
1; 986; 2961; 5; 4946; 1985 
1; 987; 2964; 5; 4951; 1987 
1; 988; 2967; 5; 4956; 1989 
1; 989; 2970; 5; 4961; 1991 
1; 990; 2973; 5; 4966; 1993 
1; 991; 2976; 5; 4971; 1995 
1; 992; 2979; 5; 4976; 1997 
1; 993; 2982; 5; 4981; 1999 
1; 994; 2985; 5; 4986; 2001 
1; 995; 2988; 5; 4991; 2003 
1; 996; 2991; 5; 4996; 2005 
1; 997; 2994; 5; 5001; 2007 
1; 998; 2997; 5; 5006; 2009 
1; 999; 3000; 5; 5011; 2011 
1; 1000; 3003; 5; 5016; 2013 
1; 1001; 3006; 5; 5021; 2015 
1; 1002; 3009; 5; 5026; 2017 
1; 1003; 3012; 5; 5031; 2019 
1; 1004; 3015; 5; 5036; 2021 
1; 1005; 3018; 5; 5041; 2023 
1; 1006; 3021; 5; 5046; 2025 
1; 1007; 3024; 5; 5051; 2027 
1; 1008; 3027; 5; 5056; 2029 
1; 1009; 3030; 5; 5061; 2031 
1; 1010; 3033; 5; 5066; 2033 
1; 1011; 3036; 5; 5071; 2035 
1; 1012; 3039; 5; 5076; 2037 
1; 1013; 3042; 5; 5081; 2039 
1; 1014; 3045; 5; 5086; 2041 
1; 1015; 3048; 5; 5091; 2043 
1; 1016; 3051; 5; 5096; 2045 
1; 1017; 3054; 5; 5101; 2047 
1; 1018; 3057; 5; 5106; 2049 
1; 1019; 3060; 5; 5111; 2051 
1; 1020; 3063; 5; 5116; 2053 
1; 1021; 3066; 5; 5121; 2055 
1; 1022; 3069; 5; 5126; 2057 
1; 1023; 3072; 5; 5131; 2059 
1; 1024; 3075; 5; 5136; 2061 
1; 1025; 3078; 5; 5141; 2063 
1; 1026; 3081; 5; 5146; 2065 
1; 1027; 3084; 5; 5151; 2067 
1; 1028; 3087; 5; 5156; 2069 
1; 1029; 3090; 5; 5161; 2071 
1; 1030; 3093; 5; 5166; 2073 
1; 1031; 3096; 5; 5171; 2075 
1; 1032; 3099; 5; 5176; 2077 
1; 1033; 3102; 5; 5181; 2079 
1; 1034; 3105; 5; 5186; 2081 
1; 1035; 3108; 5; 5191; 2083 
1; 1036; 3111; 5; 5196; 2085 
1; 1037; 3114; 5; 5201; 2087 
1; 1038; 3117; 5; 5206; 2089 
1; 1039; 3120; 5; 5211; 2091 
1; 1040; 3123; 5; 5216; 2093 
1; 1041; 3126; 5; 5221; 2095 
1; 1042; 3129; 5; 5226; 2097 
1; 1043; 3132; 5; 5231; 2099 
1; 1044; 3135; 5; 5236; 2101 
1; 1045; 3138; 5; 5241; 2103 
1; 1046; 3141; 5; 5246; 2105 
1; 1047; 3144; 5; 5251; 2107 
1; 1048; 3147; 5; 5256; 2109 
1; 1049; 3150; 5; 5261; 2111 
1; 1050; 3153; 5; 5266; 2113 
1; 1051; 3156; 5; 5271; 2115 
1; 1052; 3159; 5; 5276; 2117 
1; 1053; 3162; 5; 5281; 2119 
1; 1054; 3165; 5; 5286; 2121 
1; 1055; 3168; 5; 5291; 2123 
1; 1056; 3171; 5; 5296; 2125 
1; 1057; 3174; 5; 5301; 2127 
1; 1058; 3177; 5; 5306; 2129 
1; 1059; 3180; 5; 5311; 2131 
1; 1060; 3183; 5; 5316; 2133 
1; 1061; 3186; 5; 5321; 2135 
1; 1062; 3189; 5; 5326; 2137 
1; 1063; 3192; 5; 5331; 2139 
1; 1064; 3195; 5; 5336; 2141 
1; 1065; 3198; 5; 5341; 2143 
1; 1066; 3201; 5; 5346; 2145 
1; 1067; 3204; 5; 5351; 2147 
1; 1068; 3207; 5; 5356; 2149 
1; 1069; 3210; 5; 5361; 2151 
1; 1070; 3213; 5; 5366; 2153 
1; 1071; 3216; 5; 5371; 2155 
1; 1072; 3219; 5; 5376; 2157 
1; 1073; 3222; 5; 5381; 2159 
1; 1074; 3225; 5; 5386; 2161 
1; 1075; 3228; 5; 5391; 2163 
1; 1076; 3231; 5; 5396; 2165 
1; 1077; 3234; 5; 5401; 2167 
1; 1078; 3237; 5; 5406; 2169 
1; 1079; 3240; 5; 5411; 2171 
1; 1080; 3243; 5; 5416; 2173 
1; 1081; 3246; 5; 5421; 2175 
1; 1082; 3249; 5; 5426; 2177 
1; 1083; 3252; 5; 5431; 2179 
1; 1084; 3255; 5; 5436; 2181 
1; 1085; 3258; 5; 5441; 2183 
1; 1086; 3261; 5; 5446; 2185 
1; 1087; 3264; 5; 5451; 2187 
1; 1088; 3267; 5; 5456; 2189 
1; 1089; 3270; 5; 5461; 2191 
1; 1090; 3273; 5; 5466; 2193 
1; 1091; 3276; 5; 5471; 2195 
1; 1092; 3279; 5; 5476; 2197 
1; 1093; 3282; 5; 5481; 2199 
1; 1094; 3285; 5; 5486; 2201 
1; 1095; 3288; 5; 5491; 2203 
1; 1096; 3291; 5; 5496; 2205 
1; 1097; 3294; 5; 5501; 2207 
1; 1098; 3297; 5; 5506; 2209 
1; 1099; 3300; 5; 5511; 2211 
1; 1100; 3303; 5; 5516; 2213 
1; 1101; 3306; 5; 5521; 2215 
1; 1102; 3309; 5; 5526; 2217 
1; 1103; 3312; 5; 5531; 2219 
1; 1104; 3315; 5; 5536; 2221 
1; 1105; 3318; 5; 5541; 2223 
1; 1106; 3321; 5; 5546; 2225 
1; 1107; 3324; 5; 5551; 2227 
1; 1108; 3327; 5; 5556; 2229 
1; 1109; 3330; 5; 5561; 2231 
1; 1110; 3333; 5; 5566; 2233 
1; 1111; 3336; 5; 5571; 2235 
1; 1112; 3339; 5; 5576; 2237 
1; 1113; 3342; 5; 5581; 2239 
1; 1114; 3345; 5; 5586; 2241 
1; 1115; 3348; 5; 5591; 2243 
1; 1116; 3351; 5; 5596; 2245 
1; 1117; 3354; 5; 5601; 2247 
1; 1118; 3357; 5; 5606; 2249 
1; 1119; 3360; 5; 5611; 2251 
1; 1120; 3363; 5; 5616; 2253 
1; 1121; 3366; 5; 5621; 2255 
1; 1122; 3369; 5; 5626; 2257 
1; 1123; 3372; 5; 5631; 2259 
1; 1124; 3375; 5; 5636; 2261 
1; 1125; 3378; 5; 5641; 2263 
1; 1126; 3381; 5; 5646; 2265 
1; 1127; 3384; 5; 5651; 2267 
1; 1128; 3387; 5; 5656; 2269 
1; 1129; 3390; 5; 5661; 2271 
1; 1130; 3393; 5; 5666; 2273 
1; 1131; 3396; 5; 5671; 2275 
1; 1132; 3399; 5; 5676; 2277 
1; 1133; 3402; 5; 5681; 2279 
1; 1134; 3405; 5; 5686; 2281 
1; 1135; 3408; 5; 5691; 2283 
1; 1136; 3411; 5; 5696; 2285 
1; 1137; 3414; 5; 5701; 2287 
1; 1138; 3417; 5; 5706; 2289 
1; 1139; 3420; 5; 5711; 2291 
1; 1140; 3423; 5; 5716; 2293 
1; 1141; 3426; 5; 5721; 2295 
1; 1142; 3429; 5; 5726; 2297 
1; 1143; 3432; 5; 5731; 2299 
1; 1144; 3435; 5; 5736; 2301 
1; 1145; 3438; 5; 5741; 2303 
1; 1146; 3441; 5; 5746; 2305 
1; 1147; 3444; 5; 5751; 2307 
1; 1148; 3447; 5; 5756; 2309 
1; 1149; 3450; 5; 5761; 2311 
1; 1150; 3453; 5; 5766; 2313 
1; 1151; 3456; 5; 5771; 2315 
1; 1152; 3459; 5; 5776; 2317 
1; 1153; 3462; 5; 5781; 2319 
1; 1154; 3465; 5; 5786; 2321 
1; 1155; 3468; 5; 5791; 2323 
1; 1156; 3471; 5; 5796; 2325 
1; 1157; 3474; 5; 5801; 2327 
1; 1158; 3477; 5; 5806; 2329 
1; 1159; 3480; 5; 5811; 2331 
1; 1160; 3483; 5; 5816; 2333 
1; 1161; 3486; 5; 5821; 2335 
1; 1162; 3489; 5; 5826; 2337 
1; 1163; 3492; 5; 5831; 2339 
1; 1164; 3495; 5; 5836; 2341 
1; 1165; 3498; 5; 5841; 2343 
1; 1166; 3501; 5; 5846; 2345 
1; 1167; 3504; 5; 5851; 2347 
1; 1168; 3507; 5; 5856; 2349 
1; 1169; 3510; 5; 5861; 2351 
1; 1170; 3513; 5; 5866; 2353 
1; 1171; 3516; 5; 5871; 2355 
1; 1172; 3519; 5; 5876; 2357 
1; 1173; 3522; 5; 5881; 2359 
1; 1174; 3525; 5; 5886; 2361 
1; 1175; 3528; 5; 5891; 2363 
1; 1176; 3531; 5; 5896; 2365 
1; 1177; 3534; 5; 5901; 2367 
1; 1178; 3537; 5; 5906; 2369 
1; 1179; 3540; 5; 5911; 2371 
1; 1180; 3543; 5; 5916; 2373 
1; 1181; 3546; 5; 5921; 2375 
1; 1182; 3549; 5; 5926; 2377 
1; 1183; 3552; 5; 5931; 2379 
1; 1184; 3555; 5; 5936; 2381 
1; 1185; 3558; 5; 5941; 2383 
1; 1186; 3561; 5; 5946; 2385 
1; 1187; 3564; 5; 5951; 2387 
1; 1188; 3567; 5; 5956; 2389 
1; 1189; 3570; 5; 5961; 2391 
1; 1190; 3573; 5; 5966; 2393 
1; 1191; 3576; 5; 5971; 2395 
1; 1192; 3579; 5; 5976; 2397 
1; 1193; 3582; 5; 5981; 2399 
1; 1194; 3585; 5; 5986; 2401 
1; 1195; 3588; 5; 5991; 2403 
1; 1196; 3591; 5; 5996; 2405 
1; 1197; 3594; 5; 6001; 2407 
1; 1198; 3597; 5; 6006; 2409 
1; 1199; 3600; 5; 6011; 2411 
1; 1200; 3603; 5; 6016; 2413 
1; 1201; 3606; 5; 6021; 2415 
1; 1202; 3609; 5; 6026; 2417 
1; 1203; 3612; 5; 6031; 2419 
1; 1204; 3615; 5; 6036; 2421 
1; 1205; 3618; 5; 6041; 2423 
1; 1206; 3621; 5; 6046; 2425 
1; 1207; 3624; 5; 6051; 2427 
1; 1208; 3627; 5; 6056; 2429 
1; 1209; 3630; 5; 6061; 2431 
1; 1210; 3633; 5; 6066; 2433 
1; 1211; 3636; 5; 6071; 2435 
1; 1212; 3639; 5; 6076; 2437 
1; 1213; 3642; 5; 6081; 2439 
1; 1214; 3645; 5; 6086; 2441 
1; 1215; 3648; 5; 6091; 2443 
1; 1216; 3651; 5; 6096; 2445 
1; 1217; 3654; 5; 6101; 2447 
1; 1218; 3657; 5; 6106; 2449 
1; 1219; 3660; 5; 6111; 2451 
1; 1220; 3663; 5; 6116; 2453 
1; 1221; 3666; 5; 6121; 2455 
1; 1222; 3669; 5; 6126; 2457 
1; 1223; 3672; 5; 6131; 2459 
1; 1224; 3675; 5; 6136; 2461 
1; 1225; 3678; 5; 6141; 2463 
1; 1226; 3681; 5; 6146; 2465 
1; 1227; 3684; 5; 6151; 2467 
1; 1228; 3687; 5; 6156; 2469 
1; 1229; 3690; 5; 6161; 2471 
1; 1230; 3693; 5; 6166; 2473 
1; 1231; 3696; 5; 6171; 2475 
1; 1232; 3699; 5; 6176; 2477 
1; 1233; 3702; 5; 6181; 2479 
1; 1234; 3705; 5; 6186; 2481 
1; 1235; 3708; 5; 6191; 2483 
1; 1236; 3711; 5; 6196; 2485 
1; 1237; 3714; 5; 6201; 2487 
1; 1238; 3717; 5; 6206; 2489 
1; 1239; 3720; 5; 6211; 2491 
1; 1240; 3723; 5; 6216; 2493 
1; 1241; 3726; 5; 6221; 2495 
1; 1242; 3729; 5; 6226; 2497 
1; 1243; 3732; 5; 6231; 2499 
1; 1244; 3735; 5; 6236; 2501 
1; 1245; 3738; 5; 6241; 2503 
1; 1246; 3741; 5; 6246; 2505 
1; 1247; 3744; 5; 6251; 2507 
1; 1248; 3747; 5; 6256; 2509 
1; 1249; 3750; 5; 6261; 2511 
1; 1250; 3753; 5; 6266; 2513 
1; 1251; 3756; 5; 6271; 2515 
1; 1252; 3759; 5; 6276; 2517 
1; 1253; 3762; 5; 6281; 2519 
1; 1254; 3765; 5; 6286; 2521 
1; 1255; 3768; 5; 6291; 2523 
1; 1256; 3771; 5; 6296; 2525 
1; 1257; 3774; 5; 6301; 2527 
1; 1258; 3777; 5; 6306; 2529 
1; 1259; 3780; 5; 6311; 2531 
1; 1260; 3783; 5; 6316; 2533 
1; 1261; 3786; 5; 6321; 2535 
1; 1262; 3789; 5; 6326; 2537 
1; 1263; 3792; 5; 6331; 2539 
1; 1264; 3795; 5; 6336; 2541 
1; 1265; 3798; 5; 6341; 2543 
1; 1266; 3801; 5; 6346; 2545 
1; 1267; 3804; 5; 6351; 2547 
1; 1268; 3807; 5; 6356; 2549 
1; 1269; 3810; 5; 6361; 2551 
1; 1270; 3813; 5; 6366; 2553 
1; 1271; 3816; 5; 6371; 2555 
1; 1272; 3819; 5; 6376; 2557 
1; 1273; 3822; 5; 6381; 2559 
1; 1274; 3825; 5; 6386; 2561 
1; 1275; 3828; 5; 6391; 2563 
1; 1276; 3831; 5; 6396; 2565 
1; 1277; 3834; 5; 6401; 2567 
1; 1278; 3837; 5; 6406; 2569 
1; 1279; 3840; 5; 6411; 2571 
1; 1280; 3843; 5; 6416; 2573 
1; 1281; 3846; 5; 6421; 2575 
1; 1282; 3849; 5; 6426; 2577 
1; 1283; 3852; 5; 6431; 2579 
1; 1284; 3855; 5; 6436; 2581 
1; 1285; 3858; 5; 6441; 2583 
1; 1286; 3861; 5; 6446; 2585 
1; 1287; 3864; 5; 6451; 2587 
1; 1288; 3867; 5; 6456; 2589 
1; 1289; 3870; 5; 6461; 2591 
1; 1290; 3873; 5; 6466; 2593 
1; 1291; 3876; 5; 6471; 2595 
1; 1292; 3879; 5; 6476; 2597 
1; 1293; 3882; 5; 6481; 2599 
1; 1294; 3885; 5; 6486; 2601 
1; 1295; 3888; 5; 6491; 2603 
1; 1296; 3891; 5; 6496; 2605 
1; 1297; 3894; 5; 6501; 2607 
1; 1298; 3897; 5; 6506; 2609 
1; 1299; 3900; 5; 6511; 2611 
1; 1300; 3903; 5; 6516; 2613 
1; 1301; 3906; 5; 6521; 2615 
1; 1302; 3909; 5; 6526; 2617 
1; 1303; 3912; 5; 6531; 2619 
1; 1304; 3915; 5; 6536; 2621 
1; 1305; 3918; 5; 6541; 2623 
1; 1306; 3921; 5; 6546; 2625 
1; 1307; 3924; 5; 6551; 2627 
1; 1308; 3927; 5; 6556; 2629 
1; 1309; 3930; 5; 6561; 2631 
1; 1310; 3933; 5; 6566; 2633 
1; 1311; 3936; 5; 6571; 2635 
1; 1312; 3939; 5; 6576; 2637 
1; 1313; 3942; 5; 6581; 2639 
1; 1314; 3945; 5; 6586; 2641 
1; 1315; 3948; 5; 6591; 2643 
1; 1316; 3951; 5; 6596; 2645 
1; 1317; 3954; 5; 6601; 2647 
1; 1318; 3957; 5; 6606; 2649 
1; 1319; 3960; 5; 6611; 2651 
1; 1320; 3963; 5; 6616; 2653 
1; 1321; 3966; 5; 6621; 2655 
1; 1322; 3969; 5; 6626; 2657 
1; 1323; 3972; 5; 6631; 2659 
1; 1324; 3975; 5; 6636; 2661 
1; 1325; 3978; 5; 6641; 2663 
1; 1326; 3981; 5; 6646; 2665 
1; 1327; 3984; 5; 6651; 2667 
1; 1328; 3987; 5; 6656; 2669 
1; 1329; 3990; 5; 6661; 2671 
1; 1330; 3993; 5; 6666; 2673 
1; 1331; 3996; 5; 6671; 2675 
1; 1332; 3999; 5; 6676; 2677 
1; 1333; 4002; 5; 6681; 2679 
1; 1334; 4005; 5; 6686; 2681 
1; 1335; 4008; 5; 6691; 2683 
1; 1336; 4011; 5; 6696; 2685 
1; 1337; 4014; 5; 6701; 2687 
1; 1338; 4017; 5; 6706; 2689 
1; 1339; 4020; 5; 6711; 2691 
1; 1340; 4023; 5; 6716; 2693 
1; 1341; 4026; 5; 6721; 2695 
1; 1342; 4029; 5; 6726; 2697 
1; 1343; 4032; 5; 6731; 2699 
1; 1344; 4035; 5; 6736; 2701 
1; 1345; 4038; 5; 6741; 2703 
1; 1346; 4041; 5; 6746; 2705 
1; 1347; 4044; 5; 6751; 2707 
1; 1348; 4047; 5; 6756; 2709 
1; 1349; 4050; 5; 6761; 2711 
1; 1350; 4053; 5; 6766; 2713 
1; 1351; 4056; 5; 6771; 2715 
1; 1352; 4059; 5; 6776; 2717 
1; 1353; 4062; 5; 6781; 2719 
1; 1354; 4065; 5; 6786; 2721 
1; 1355; 4068; 5; 6791; 2723 
1; 1356; 4071; 5; 6796; 2725 
1; 1357; 4074; 5; 6801; 2727 
1; 1358; 4077; 5; 6806; 2729 
1; 1359; 4080; 5; 6811; 2731 
1; 1360; 4083; 5; 6816; 2733 
1; 1361; 4086; 5; 6821; 2735 
1; 1362; 4089; 5; 6826; 2737 
1; 1363; 4092; 5; 6831; 2739 
1; 1364; 4095; 5; 6836; 2741 
1; 1365; 4098; 5; 6841; 2743 
1; 1366; 4101; 5; 6846; 2745 
1; 1367; 4104; 5; 6851; 2747 
1; 1368; 4107; 5; 6856; 2749 
1; 1369; 4110; 5; 6861; 2751 
1; 1370; 4113; 5; 6866; 2753 
1; 1371; 4116; 5; 6871; 2755 
1; 1372; 4119; 5; 6876; 2757 
1; 1373; 4122; 5; 6881; 2759 
1; 1374; 4125; 5; 6886; 2761 
1; 1375; 4128; 5; 6891; 2763 
1; 1376; 4131; 5; 6896; 2765 
1; 1377; 4134; 5; 6901; 2767 
1; 1378; 4137; 5; 6906; 2769 
1; 1379; 4140; 5; 6911; 2771 
1; 1380; 4143; 5; 6916; 2773 
1; 1381; 4146; 5; 6921; 2775 
1; 1382; 4149; 5; 6926; 2777 
1; 1383; 4152; 5; 6931; 2779 
1; 1384; 4155; 5; 6936; 2781 
1; 1385; 4158; 5; 6941; 2783 
1; 1386; 4161; 5; 6946; 2785 
1; 1387; 4164; 5; 6951; 2787 
1; 1388; 4167; 5; 6956; 2789 
1; 1389; 4170; 5; 6961; 2791 
1; 1390; 4173; 5; 6966; 2793 
1; 1391; 4176; 5; 6971; 2795 
1; 1392; 4179; 5; 6976; 2797 
1; 1393; 4182; 5; 6981; 2799 
1; 1394; 4185; 5; 6986; 2801 
1; 1395; 4188; 5; 6991; 2803 
1; 1396; 4191; 5; 6996; 2805 
1; 1397; 4194; 5; 7001; 2807 
1; 1398; 4197; 5; 7006; 2809 
1; 1399; 4200; 5; 7011; 2811 
1; 1400; 4203; 5; 7016; 2813 
1; 1401; 4206; 5; 7021; 2815 
1; 1402; 4209; 5; 7026; 2817 
1; 1403; 4212; 5; 7031; 2819 
1; 1404; 4215; 5; 7036; 2821 
1; 1405; 4218; 5; 7041; 2823 
1; 1406; 4221; 5; 7046; 2825 
1; 1407; 4224; 5; 7051; 2827 
1; 1408; 4227; 5; 7056; 2829 
1; 1409; 4230; 5; 7061; 2831 
1; 1410; 4233; 5; 7066; 2833 
1; 1411; 4236; 5; 7071; 2835 
1; 1412; 4239; 5; 7076; 2837 
1; 1413; 4242; 5; 7081; 2839 
1; 1414; 4245; 5; 7086; 2841 
1; 1415; 4248; 5; 7091; 2843 
1; 1416; 4251; 5; 7096; 2845 
1; 1417; 4254; 5; 7101; 2847 
1; 1418; 4257; 5; 7106; 2849 
1; 1419; 4260; 5; 7111; 2851 
1; 1420; 4263; 5; 7116; 2853 
1; 1421; 4266; 5; 7121; 2855 
1; 1422; 4269; 5; 7126; 2857 
1; 1423; 4272; 5; 7131; 2859 
1; 1424; 4275; 5; 7136; 2861 
1; 1425; 4278; 5; 7141; 2863 
1; 1426; 4281; 5; 7146; 2865 
1; 1427; 4284; 5; 7151; 2867 
1; 1428; 4287; 5; 7156; 2869 
1; 1429; 4290; 5; 7161; 2871 
1; 1430; 4293; 5; 7166; 2873 
1; 1431; 4296; 5; 7171; 2875 
1; 1432; 4299; 5; 7176; 2877 
1; 1433; 4302; 5; 7181; 2879 
1; 1434; 4305; 5; 7186; 2881 
1; 1435; 4308; 5; 7191; 2883 
1; 1436; 4311; 5; 7196; 2885 
1; 1437; 4314; 5; 7201; 2887 
1; 1438; 4317; 5; 7206; 2889 
1; 1439; 4320; 5; 7211; 2891 
1; 1440; 4323; 5; 7216; 2893 
1; 1441; 4326; 5; 7221; 2895 
1; 1442; 4329; 5; 7226; 2897 
1; 1443; 4332; 5; 7231; 2899 
1; 1444; 4335; 5; 7236; 2901 
1; 1445; 4338; 5; 7241; 2903 
1; 1446; 4341; 5; 7246; 2905 
1; 1447; 4344; 5; 7251; 2907 
1; 1448; 4347; 5; 7256; 2909 
1; 1449; 4350; 5; 7261; 2911 
1; 1450; 4353; 5; 7266; 2913 
1; 1451; 4356; 5; 7271; 2915 
1; 1452; 4359; 5; 7276; 2917 
1; 1453; 4362; 5; 7281; 2919 
1; 1454; 4365; 5; 7286; 2921 
1; 1455; 4368; 5; 7291; 2923 
1; 1456; 4371; 5; 7296; 2925 
1; 1457; 4374; 5; 7301; 2927 
1; 1458; 4377; 5; 7306; 2929 
1; 1459; 4380; 5; 7311; 2931 
1; 1460; 4383; 5; 7316; 2933 
1; 1461; 4386; 5; 7321; 2935 
1; 1462; 4389; 5; 7326; 2937 
1; 1463; 4392; 5; 7331; 2939 
1; 1464; 4395; 5; 7336; 2941 
1; 1465; 4398; 5; 7341; 2943 
1; 1466; 4401; 5; 7346; 2945 
1; 1467; 4404; 5; 7351; 2947 
1; 1468; 4407; 5; 7356; 2949 
1; 1469; 4410; 5; 7361; 2951 
1; 1470; 4413; 5; 7366; 2953 
1; 1471; 4416; 5; 7371; 2955 
1; 1472; 4419; 5; 7376; 2957 
1; 1473; 4422; 5; 7381; 2959 
1; 1474; 4425; 5; 7386; 2961 
1; 1475; 4428; 5; 7391; 2963 
1; 1476; 4431; 5; 7396; 2965 
1; 1477; 4434; 5; 7401; 2967 
1; 1478; 4437; 5; 7406; 2969 
1; 1479; 4440; 5; 7411; 2971 
1; 1480; 4443; 5; 7416; 2973 
1; 1481; 4446; 5; 7421; 2975 
1; 1482; 4449; 5; 7426; 2977 
1; 1483; 4452; 5; 7431; 2979 
1; 1484; 4455; 5; 7436; 2981 
1; 1485; 4458; 5; 7441; 2983 
1; 1486; 4461; 5; 7446; 2985 
1; 1487; 4464; 5; 7451; 2987 
1; 1488; 4467; 5; 7456; 2989 
1; 1489; 4470; 5; 7461; 2991 
1; 1490; 4473; 5; 7466; 2993 
1; 1491; 4476; 5; 7471; 2995 
1; 1492; 4479; 5; 7476; 2997 
1; 1493; 4482; 5; 7481; 2999 
1; 1494; 4485; 5; 7486; 3001 
1; 1495; 4488; 5; 7491; 3003 
1; 1496; 4491; 5; 7496; 3005 
1; 1497; 4494; 5; 7501; 3007 
1; 1498; 4497; 5; 7506; 3009 
1; 1499; 4500; 5; 7511; 3011 
1; 1500; 4503; 5; 7516; 3013 
1; 1501; 4506; 5; 7521; 3015 
1; 1502; 4509; 5; 7526; 3017 
1; 1503; 4512; 5; 7531; 3019 
1; 1504; 4515; 5; 7536; 3021 
1; 1505; 4518; 5; 7541; 3023 
1; 1506; 4521; 5; 7546; 3025 
1; 1507; 4524; 5; 7551; 3027 
1; 1508; 4527; 5; 7556; 3029 
1; 1509; 4530; 5; 7561; 3031 
1; 1510; 4533; 5; 7566; 3033 
1; 1511; 4536; 5; 7571; 3035 
1; 1512; 4539; 5; 7576; 3037 
1; 1513; 4542; 5; 7581; 3039 
1; 1514; 4545; 5; 7586; 3041 
1; 1515; 4548; 5; 7591; 3043 
1; 1516; 4551; 5; 7596; 3045 
1; 1517; 4554; 5; 7601; 3047 
1; 1518; 4557; 5; 7606; 3049 
1; 1519; 4560; 5; 7611; 3051 
1; 1520; 4563; 5; 7616; 3053 
1; 1521; 4566; 5; 7621; 3055 
1; 1522; 4569; 5; 7626; 3057 
1; 1523; 4572; 5; 7631; 3059 
1; 1524; 4575; 5; 7636; 3061 
1; 1525; 4578; 5; 7641; 3063 
1; 1526; 4581; 5; 7646; 3065 
1; 1527; 4584; 5; 7651; 3067 
1; 1528; 4587; 5; 7656; 3069 
1; 1529; 4590; 5; 7661; 3071 
1; 1530; 4593; 5; 7666; 3073 
1; 1531; 4596; 5; 7671; 3075 
1; 1532; 4599; 5; 7676; 3077 
1; 1533; 4602; 5; 7681; 3079 
1; 1534; 4605; 5; 7686; 3081 
1; 1535; 4608; 5; 7691; 3083 
1; 1536; 4611; 5; 7696; 3085 
1; 1537; 4614; 5; 7701; 3087 
1; 1538; 4617; 5; 7706; 3089 
1; 1539; 4620; 5; 7711; 3091 
1; 1540; 4623; 5; 7716; 3093 
1; 1541; 4626; 5; 7721; 3095 
1; 1542; 4629; 5; 7726; 3097 
1; 1543; 4632; 5; 7731; 3099 
1; 1544; 4635; 5; 7736; 3101 
1; 1545; 4638; 5; 7741; 3103 
1; 1546; 4641; 5; 7746; 3105 
1; 1547; 4644; 5; 7751; 3107 
1; 1548; 4647; 5; 7756; 3109 
1; 1549; 4650; 5; 7761; 3111 
1; 1550; 4653; 5; 7766; 3113 
1; 1551; 4656; 5; 7771; 3115 
1; 1552; 4659; 5; 7776; 3117 
1; 1553; 4662; 5; 7781; 3119 
1; 1554; 4665; 5; 7786; 3121 
1; 1555; 4668; 5; 7791; 3123 
1; 1556; 4671; 5; 7796; 3125 
1; 1557; 4674; 5; 7801; 3127 
1; 1558; 4677; 5; 7806; 3129 
1; 1559; 4680; 5; 7811; 3131 
1; 1560; 4683; 5; 7816; 3133 
1; 1561; 4686; 5; 7821; 3135 
1; 1562; 4689; 5; 7826; 3137 
1; 1563; 4692; 5; 7831; 3139 
1; 1564; 4695; 5; 7836; 3141 
1; 1565; 4698; 5; 7841; 3143 
1; 1566; 4701; 5; 7846; 3145 
1; 1567; 4704; 5; 7851; 3147 
1; 1568; 4707; 5; 7856; 3149 
1; 1569; 4710; 5; 7861; 3151 
1; 1570; 4713; 5; 7866; 3153 
1; 1571; 4716; 5; 7871; 3155 
1; 1572; 4719; 5; 7876; 3157 
1; 1573; 4722; 5; 7881; 3159 
1; 1574; 4725; 5; 7886; 3161 
1; 1575; 4728; 5; 7891; 3163 
1; 1576; 4731; 5; 7896; 3165 
1; 1577; 4734; 5; 7901; 3167 
1; 1578; 4737; 5; 7906; 3169 
1; 1579; 4740; 5; 7911; 3171 
1; 1580; 4743; 5; 7916; 3173 
1; 1581; 4746; 5; 7921; 3175 
1; 1582; 4749; 5; 7926; 3177 
1; 1583; 4752; 5; 7931; 3179 
1; 1584; 4755; 5; 7936; 3181 
1; 1585; 4758; 5; 7941; 3183 
1; 1586; 4761; 5; 7946; 3185 
1; 1587; 4764; 5; 7951; 3187 
1; 1588; 4767; 5; 7956; 3189 
1; 1589; 4770; 5; 7961; 3191 
1; 1590; 4773; 5; 7966; 3193 
1; 1591; 4776; 5; 7971; 3195 
1; 1592; 4779; 5; 7976; 3197 
1; 1593; 4782; 5; 7981; 3199 
1; 1594; 4785; 5; 7986; 3201 
1; 1595; 4788; 5; 7991; 3203 
1; 1596; 4791; 5; 7996; 3205 
1; 1597; 4794; 5; 8001; 3207 
1; 1598; 4797; 5; 8006; 3209 
1; 1599; 4800; 5; 8011; 3211 
1; 1600; 4803; 5; 8016; 3213 
1; 1601; 4806; 5; 8021; 3215 
1; 1602; 4809; 5; 8026; 3217 
1; 1603; 4812; 5; 8031; 3219 
1; 1604; 4815; 5; 8036; 3221 
1; 1605; 4818; 5; 8041; 3223 
1; 1606; 4821; 5; 8046; 3225 
1; 1607; 4824; 5; 8051; 3227 
1; 1608; 4827; 5; 8056; 3229 
1; 1609; 4830; 5; 8061; 3231 
1; 1610; 4833; 5; 8066; 3233 
1; 1611; 4836; 5; 8071; 3235 
1; 1612; 4839; 5; 8076; 3237 
1; 1613; 4842; 5; 8081; 3239 
1; 1614; 4845; 5; 8086; 3241 
1; 1615; 4848; 5; 8091; 3243 
1; 1616; 4851; 5; 8096; 3245 
1; 1617; 4854; 5; 8101; 3247 
1; 1618; 4857; 5; 8106; 3249 
1; 1619; 4860; 5; 8111; 3251 
1; 1620; 4863; 5; 8116; 3253 
1; 1621; 4866; 5; 8121; 3255 
1; 1622; 4869; 5; 8126; 3257 
1; 1623; 4872; 5; 8131; 3259 
1; 1624; 4875; 5; 8136; 3261 
1; 1625; 4878; 5; 8141; 3263 
1; 1626; 4881; 5; 8146; 3265 
1; 1627; 4884; 5; 8151; 3267 
1; 1628; 4887; 5; 8156; 3269 
1; 1629; 4890; 5; 8161; 3271 
1; 1630; 4893; 5; 8166; 3273 
1; 1631; 4896; 5; 8171; 3275 
1; 1632; 4899; 5; 8176; 3277 
1; 1633; 4902; 5; 8181; 3279 
1; 1634; 4905; 5; 8186; 3281 
1; 1635; 4908; 5; 8191; 3283 
1; 1636; 4911; 5; 8196; 3285 
1; 1637; 4914; 5; 8201; 3287 
1; 1638; 4917; 5; 8206; 3289 
1; 1639; 4920; 5; 8211; 3291 
1; 1640; 4923; 5; 8216; 3293 
1; 1641; 4926; 5; 8221; 3295 
1; 1642; 4929; 5; 8226; 3297 
1; 1643; 4932; 5; 8231; 3299 
1; 1644; 4935; 5; 8236; 3301 
1; 1645; 4938; 5; 8241; 3303 
1; 1646; 4941; 5; 8246; 3305 
1; 1647; 4944; 5; 8251; 3307 
1; 1648; 4947; 5; 8256; 3309 
1; 1649; 4950; 5; 8261; 3311 
1; 1650; 4953; 5; 8266; 3313 
1; 1651; 4956; 5; 8271; 3315 
1; 1652; 4959; 5; 8276; 3317 
1; 1653; 4962; 5; 8281; 3319 
1; 1654; 4965; 5; 8286; 3321 
1; 1655; 4968; 5; 8291; 3323 
1; 1656; 4971; 5; 8296; 3325 
1; 1657; 4974; 5; 8301; 3327 
1; 1658; 4977; 5; 8306; 3329 
1; 1659; 4980; 5; 8311; 3331 
1; 1660; 4983; 5; 8316; 3333 
1; 1661; 4986; 5; 8321; 3335 
1; 1662; 4989; 5; 8326; 3337 
1; 1663; 4992; 5; 8331; 3339 
1; 1664; 4995; 5; 8336; 3341 
1; 1665; 4998; 5; 8341; 3343 
1; 1666; 5001; 5; 8346; 3345 
1; 1667; 5004; 5; 8351; 3347 
1; 1668; 5007; 5; 8356; 3349 
1; 1669; 5010; 5; 8361; 3351 
1; 1670; 5013; 5; 8366; 3353 
1; 1671; 5016; 5; 8371; 3355 
1; 1672; 5019; 5; 8376; 3357 
1; 1673; 5022; 5; 8381; 3359 
1; 1674; 5025; 5; 8386; 3361 
1; 1675; 5028; 5; 8391; 3363 
1; 1676; 5031; 5; 8396; 3365 
1; 1677; 5034; 5; 8401; 3367 
1; 1678; 5037; 5; 8406; 3369 
1; 1679; 5040; 5; 8411; 3371 
1; 1680; 5043; 5; 8416; 3373 
1; 1681; 5046; 5; 8421; 3375 
1; 1682; 5049; 5; 8426; 3377 
1; 1683; 5052; 5; 8431; 3379 
1; 1684; 5055; 5; 8436; 3381 
1; 1685; 5058; 5; 8441; 3383 
1; 1686; 5061; 5; 8446; 3385 
1; 1687; 5064; 5; 8451; 3387 
1; 1688; 5067; 5; 8456; 3389 
1; 1689; 5070; 5; 8461; 3391 
1; 1690; 5073; 5; 8466; 3393 
1; 1691; 5076; 5; 8471; 3395 
1; 1692; 5079; 5; 8476; 3397 
1; 1693; 5082; 5; 8481; 3399 
1; 1694; 5085; 5; 8486; 3401 
1; 1695; 5088; 5; 8491; 3403 
1; 1696; 5091; 5; 8496; 3405 
1; 1697; 5094; 5; 8501; 3407 
1; 1698; 5097; 5; 8506; 3409 
1; 1699; 5100; 5; 8511; 3411 
1; 1700; 5103; 5; 8516; 3413 
1; 1701; 5106; 5; 8521; 3415 
1; 1702; 5109; 5; 8526; 3417 
1; 1703; 5112; 5; 8531; 3419 
1; 1704; 5115; 5; 8536; 3421 
1; 1705; 5118; 5; 8541; 3423 
1; 1706; 5121; 5; 8546; 3425 
1; 1707; 5124; 5; 8551; 3427 
1; 1708; 5127; 5; 8556; 3429 
1; 1709; 5130; 5; 8561; 3431 
1; 1710; 5133; 5; 8566; 3433 
1; 1711; 5136; 5; 8571; 3435 
1; 1712; 5139; 5; 8576; 3437 
1; 1713; 5142; 5; 8581; 3439 
1; 1714; 5145; 5; 8586; 3441 
1; 1715; 5148; 5; 8591; 3443 
1; 1716; 5151; 5; 8596; 3445 
1; 1717; 5154; 5; 8601; 3447 
1; 1718; 5157; 5; 8606; 3449 
1; 1719; 5160; 5; 8611; 3451 
1; 1720; 5163; 5; 8616; 3453 
1; 1721; 5166; 5; 8621; 3455 
1; 1722; 5169; 5; 8626; 3457 
1; 1723; 5172; 5; 8631; 3459 
1; 1724; 5175; 5; 8636; 3461 
1; 1725; 5178; 5; 8641; 3463 
1; 1726; 5181; 5; 8646; 3465 
1; 1727; 5184; 5; 8651; 3467 
1; 1728; 5187; 5; 8656; 3469 
1; 1729; 5190; 5; 8661; 3471 
1; 1730; 5193; 5; 8666; 3473 
1; 1731; 5196; 5; 8671; 3475 
1; 1732; 5199; 5; 8676; 3477 
1; 1733; 5202; 5; 8681; 3479 
1; 1734; 5205; 5; 8686; 3481 
1; 1735; 5208; 5; 8691; 3483 
1; 1736; 5211; 5; 8696; 3485 
1; 1737; 5214; 5; 8701; 3487 
1; 1738; 5217; 5; 8706; 3489 
1; 1739; 5220; 5; 8711; 3491 
1; 1740; 5223; 5; 8716; 3493 
1; 1741; 5226; 5; 8721; 3495 
1; 1742; 5229; 5; 8726; 3497 
1; 1743; 5232; 5; 8731; 3499 
1; 1744; 5235; 5; 8736; 3501 
1; 1745; 5238; 5; 8741; 3503 
1; 1746; 5241; 5; 8746; 3505 
1; 1747; 5244; 5; 8751; 3507 
1; 1748; 5247; 5; 8756; 3509 
1; 1749; 5250; 5; 8761; 3511 
1; 1750; 5253; 5; 8766; 3513 
1; 1751; 5256; 5; 8771; 3515 
1; 1752; 5259; 5; 8776; 3517 
1; 1753; 5262; 5; 8781; 3519 
1; 1754; 5265; 5; 8786; 3521 
1; 1755; 5268; 5; 8791; 3523 
1; 1756; 5271; 5; 8796; 3525 
1; 1757; 5274; 5; 8801; 3527 
1; 1758; 5277; 5; 8806; 3529 
1; 1759; 5280; 5; 8811; 3531 
1; 1760; 5283; 5; 8816; 3533 
1; 1761; 5286; 5; 8821; 3535 
1; 1762; 5289; 5; 8826; 3537 
1; 1763; 5292; 5; 8831; 3539 
1; 1764; 5295; 5; 8836; 3541 
1; 1765; 5298; 5; 8841; 3543 
1; 1766; 5301; 5; 8846; 3545 
1; 1767; 5304; 5; 8851; 3547 
1; 1768; 5307; 5; 8856; 3549 
1; 1769; 5310; 5; 8861; 3551 
1; 1770; 5313; 5; 8866; 3553 
1; 1771; 5316; 5; 8871; 3555 
1; 1772; 5319; 5; 8876; 3557 
1; 1773; 5322; 5; 8881; 3559 
1; 1774; 5325; 5; 8886; 3561 
1; 1775; 5328; 5; 8891; 3563 
1; 1776; 5331; 5; 8896; 3565 
1; 1777; 5334; 5; 8901; 3567 
1; 1778; 5337; 5; 8906; 3569 
1; 1779; 5340; 5; 8911; 3571 
1; 1780; 5343; 5; 8916; 3573 
1; 1781; 5346; 5; 8921; 3575 
1; 1782; 5349; 5; 8926; 3577 
1; 1783; 5352; 5; 8931; 3579 
1; 1784; 5355; 5; 8936; 3581 
1; 1785; 5358; 5; 8941; 3583 
1; 1786; 5361; 5; 8946; 3585 
1; 1787; 5364; 5; 8951; 3587 
1; 1788; 5367; 5; 8956; 3589 
1; 1789; 5370; 5; 8961; 3591 
1; 1790; 5373; 5; 8966; 3593 
1; 1791; 5376; 5; 8971; 3595 
1; 1792; 5379; 5; 8976; 3597 
1; 1793; 5382; 5; 8981; 3599 
1; 1794; 5385; 5; 8986; 3601 
1; 1795; 5388; 5; 8991; 3603 
1; 1796; 5391; 5; 8996; 3605 
1; 1797; 5394; 5; 9001; 3607 
1; 1798; 5397; 5; 9006; 3609 
1; 1799; 5400; 5; 9011; 3611 
1; 1800; 5403; 5; 9016; 3613 
1; 1801; 5406; 5; 9021; 3615 
1; 1802; 5409; 5; 9026; 3617 
1; 1803; 5412; 5; 9031; 3619 
1; 1804; 5415; 5; 9036; 3621 
1; 1805; 5418; 5; 9041; 3623 
1; 1806; 5421; 5; 9046; 3625 
1; 1807; 5424; 5; 9051; 3627 
1; 1808; 5427; 5; 9056; 3629 
1; 1809; 5430; 5; 9061; 3631 
1; 1810; 5433; 5; 9066; 3633 
1; 1811; 5436; 5; 9071; 3635 
1; 1812; 5439; 5; 9076; 3637 
1; 1813; 5442; 5; 9081; 3639 
1; 1814; 5445; 5; 9086; 3641 
1; 1815; 5448; 5; 9091; 3643 
1; 1816; 5451; 5; 9096; 3645 
1; 1817; 5454; 5; 9101; 3647 
1; 1818; 5457; 5; 9106; 3649 
1; 1819; 5460; 5; 9111; 3651 
1; 1820; 5463; 5; 9116; 3653 
1; 1821; 5466; 5; 9121; 3655 
1; 1822; 5469; 5; 9126; 3657 
1; 1823; 5472; 5; 9131; 3659 
1; 1824; 5475; 5; 9136; 3661 
1; 1825; 5478; 5; 9141; 3663 
1; 1826; 5481; 5; 9146; 3665 
1; 1827; 5484; 5; 9151; 3667 
1; 1828; 5487; 5; 9156; 3669 
1; 1829; 5490; 5; 9161; 3671 
1; 1830; 5493; 5; 9166; 3673 
1; 1831; 5496; 5; 9171; 3675 
1; 1832; 5499; 5; 9176; 3677 
1; 1833; 5502; 5; 9181; 3679 
1; 1834; 5505; 5; 9186; 3681 
1; 1835; 5508; 5; 9191; 3683 
1; 1836; 5511; 5; 9196; 3685 
1; 1837; 5514; 5; 9201; 3687 
1; 1838; 5517; 5; 9206; 3689 
1; 1839; 5520; 5; 9211; 3691 
1; 1840; 5523; 5; 9216; 3693 
1; 1841; 5526; 5; 9221; 3695 
1; 1842; 5529; 5; 9226; 3697 
1; 1843; 5532; 5; 9231; 3699 
1; 1844; 5535; 5; 9236; 3701 
1; 1845; 5538; 5; 9241; 3703 
1; 1846; 5541; 5; 9246; 3705 
1; 1847; 5544; 5; 9251; 3707 
1; 1848; 5547; 5; 9256; 3709 
1; 1849; 5550; 5; 9261; 3711 
1; 1850; 5553; 5; 9266; 3713 
1; 1851; 5556; 5; 9271; 3715 
1; 1852; 5559; 5; 9276; 3717 
1; 1853; 5562; 5; 9281; 3719 
1; 1854; 5565; 5; 9286; 3721 
1; 1855; 5568; 5; 9291; 3723 
1; 1856; 5571; 5; 9296; 3725 
1; 1857; 5574; 5; 9301; 3727 
1; 1858; 5577; 5; 9306; 3729 
1; 1859; 5580; 5; 9311; 3731 
1; 1860; 5583; 5; 9316; 3733 
1; 1861; 5586; 5; 9321; 3735 
1; 1862; 5589; 5; 9326; 3737 
1; 1863; 5592; 5; 9331; 3739 
1; 1864; 5595; 5; 9336; 3741 
1; 1865; 5598; 5; 9341; 3743 
1; 1866; 5601; 5; 9346; 3745 
1; 1867; 5604; 5; 9351; 3747 
1; 1868; 5607; 5; 9356; 3749 
1; 1869; 5610; 5; 9361; 3751 
1; 1870; 5613; 5; 9366; 3753 
1; 1871; 5616; 5; 9371; 3755 
1; 1872; 5619; 5; 9376; 3757 
1; 1873; 5622; 5; 9381; 3759 
1; 1874; 5625; 5; 9386; 3761 
1; 1875; 5628; 5; 9391; 3763 
1; 1876; 5631; 5; 9396; 3765 
1; 1877; 5634; 5; 9401; 3767 
1; 1878; 5637; 5; 9406; 3769 
1; 1879; 5640; 5; 9411; 3771 
1; 1880; 5643; 5; 9416; 3773 
1; 1881; 5646; 5; 9421; 3775 
1; 1882; 5649; 5; 9426; 3777 
1; 1883; 5652; 5; 9431; 3779 
1; 1884; 5655; 5; 9436; 3781 
1; 1885; 5658; 5; 9441; 3783 
1; 1886; 5661; 5; 9446; 3785 
1; 1887; 5664; 5; 9451; 3787 
1; 1888; 5667; 5; 9456; 3789 
1; 1889; 5670; 5; 9461; 3791 
1; 1890; 5673; 5; 9466; 3793 
1; 1891; 5676; 5; 9471; 3795 
1; 1892; 5679; 5; 9476; 3797 
1; 1893; 5682; 5; 9481; 3799 
1; 1894; 5685; 5; 9486; 3801 
1; 1895; 5688; 5; 9491; 3803 
1; 1896; 5691; 5; 9496; 3805 
1; 1897; 5694; 5; 9501; 3807 
1; 1898; 5697; 5; 9506; 3809 
1; 1899; 5700; 5; 9511; 3811 
1; 1900; 5703; 5; 9516; 3813 
1; 1901; 5706; 5; 9521; 3815 
1; 1902; 5709; 5; 9526; 3817 
1; 1903; 5712; 5; 9531; 3819 
1; 1904; 5715; 5; 9536; 3821 
1; 1905; 5718; 5; 9541; 3823 
1; 1906; 5721; 5; 9546; 3825 
1; 1907; 5724; 5; 9551; 3827 
1; 1908; 5727; 5; 9556; 3829 
1; 1909; 5730; 5; 9561; 3831 
1; 1910; 5733; 5; 9566; 3833 
1; 1911; 5736; 5; 9571; 3835 
1; 1912; 5739; 5; 9576; 3837 
1; 1913; 5742; 5; 9581; 3839 
1; 1914; 5745; 5; 9586; 3841 
1; 1915; 5748; 5; 9591; 3843 
1; 1916; 5751; 5; 9596; 3845 
1; 1917; 5754; 5; 9601; 3847 
1; 1918; 5757; 5; 9606; 3849 
1; 1919; 5760; 5; 9611; 3851 
1; 1920; 5763; 5; 9616; 3853 
1; 1921; 5766; 5; 9621; 3855 
1; 1922; 5769; 5; 9626; 3857 
1; 1923; 5772; 5; 9631; 3859 
1; 1924; 5775; 5; 9636; 3861 
1; 1925; 5778; 5; 9641; 3863 
1; 1926; 5781; 5; 9646; 3865 
1; 1927; 5784; 5; 9651; 3867 
1; 1928; 5787; 5; 9656; 3869 
1; 1929; 5790; 5; 9661; 3871 
1; 1930; 5793; 5; 9666; 3873 
1; 1931; 5796; 5; 9671; 3875 
1; 1932; 5799; 5; 9676; 3877 
1; 1933; 5802; 5; 9681; 3879 
1; 1934; 5805; 5; 9686; 3881 
1; 1935; 5808; 5; 9691; 3883 
1; 1936; 5811; 5; 9696; 3885 
1; 1937; 5814; 5; 9701; 3887 
1; 1938; 5817; 5; 9706; 3889 
1; 1939; 5820; 5; 9711; 3891 
1; 1940; 5823; 5; 9716; 3893 
1; 1941; 5826; 5; 9721; 3895 
1; 1942; 5829; 5; 9726; 3897 
1; 1943; 5832; 5; 9731; 3899 
1; 1944; 5835; 5; 9736; 3901 
1; 1945; 5838; 5; 9741; 3903 
1; 1946; 5841; 5; 9746; 3905 
1; 1947; 5844; 5; 9751; 3907 
1; 1948; 5847; 5; 9756; 3909 
1; 1949; 5850; 5; 9761; 3911 
1; 1950; 5853; 5; 9766; 3913 
1; 1951; 5856; 5; 9771; 3915 
1; 1952; 5859; 5; 9776; 3917 
1; 1953; 5862; 5; 9781; 3919 
1; 1954; 5865; 5; 9786; 3921 
1; 1955; 5868; 5; 9791; 3923 
1; 1956; 5871; 5; 9796; 3925 
1; 1957; 5874; 5; 9801; 3927 
1; 1958; 5877; 5; 9806; 3929 
1; 1959; 5880; 5; 9811; 3931 
1; 1960; 5883; 5; 9816; 3933 
1; 1961; 5886; 5; 9821; 3935 
1; 1962; 5889; 5; 9826; 3937 
1; 1963; 5892; 5; 9831; 3939 
1; 1964; 5895; 5; 9836; 3941 
1; 1965; 5898; 5; 9841; 3943 
1; 1966; 5901; 5; 9846; 3945 
1; 1967; 5904; 5; 9851; 3947 
1; 1968; 5907; 5; 9856; 3949 
1; 1969; 5910; 5; 9861; 3951 
1; 1970; 5913; 5; 9866; 3953 
1; 1971; 5916; 5; 9871; 3955 
1; 1972; 5919; 5; 9876; 3957 
1; 1973; 5922; 5; 9881; 3959 
1; 1974; 5925; 5; 9886; 3961 
1; 1975; 5928; 5; 9891; 3963 
1; 1976; 5931; 5; 9896; 3965 
1; 1977; 5934; 5; 9901; 3967 
1; 1978; 5937; 5; 9906; 3969 
1; 1979; 5940; 5; 9911; 3971 
1; 1980; 5943; 5; 9916; 3973 
1; 1981; 5946; 5; 9921; 3975 
1; 1982; 5949; 5; 9926; 3977 
1; 1983; 5952; 5; 9931; 3979 
1; 1984; 5955; 5; 9936; 3981 
1; 1985; 5958; 5; 9941; 3983 
1; 1986; 5961; 5; 9946; 3985 
1; 1987; 5964; 5; 9951; 3987 
1; 1988; 5967; 5; 9956; 3989 
1; 1989; 5970; 5; 9961; 3991 
1; 1990; 5973; 5; 9966; 3993 
1; 1991; 5976; 5; 9971; 3995 
1; 1992; 5979; 5; 9976; 3997 
1; 1993; 5982; 5; 9981; 3999 
1; 1994; 5985; 5; 9986; 4001 
1; 1995; 5988; 5; 9991; 4003 
1; 1996; 5991; 5; 9996; 4005 
1; 1997; 5994; 5; 10001; 4007 
1; 1998; 5997; 5; 10006; 4009 
1; 1999; 6000; 5; 10011; 4011 
1; 2000; 6003; 5; 10016; 4013 
