Grupo; Processo; Inst. Chegada; Tempo de Servi√ßo; Inst. Atendimento; Tempo Perm. Fila 
Grupo 1 
1; 1; 6; 5; 8; 2 
1; 2; 9; 5; 14; 5 
1; 3; 12; 5; 20; 8 
1; 4; 15; 5; 26; 11 
1; 5; 18; 5; 32; 14 
1; 6; 21; 5; 38; 17 
1; 7; 24; 5; 55; 31 
1; 8; 27; 5; 61; 34 
1; 9; 30; 5; 67; 37 
1; 10; 33; 5; 73; 40 
1; 11; 36; 5; 79; 43 
1; 12; 39; 5; 85; 46 
1; 13; 42; 5; 91; 49 
1; 14; 45; 5; 97; 52 
1; 15; 48; 5; 103; 55 
1; 16; 51; 5; 109; 58 
1; 17; 54; 5; 115; 61 
1; 18; 57; 5; 121; 64 
1; 19; 60; 5; 127; 67 
1; 20; 63; 5; 133; 70 
1; 21; 66; 5; 139; 73 
1; 22; 69; 5; 145; 76 
1; 23; 72; 5; 151; 79 
1; 24; 75; 5; 157; 82 
1; 25; 78; 5; 163; 85 
1; 26; 81; 5; 169; 88 
1; 27; 84; 5; 175; 91 
1; 28; 87; 5; 181; 94 
1; 29; 90; 5; 187; 97 
1; 30; 93; 5; 193; 100 
1; 31; 96; 5; 199; 103 
1; 32; 99; 5; 205; 106 
1; 33; 102; 5; 211; 109 
1; 34; 105; 5; 217; 112 
1; 35; 108; 5; 223; 115 
1; 36; 111; 5; 229; 118 
1; 37; 114; 5; 235; 121 
1; 38; 117; 5; 241; 124 
1; 39; 120; 5; 247; 127 
1; 40; 123; 5; 253; 130 
1; 41; 126; 5; 259; 133 
1; 42; 129; 5; 265; 136 
1; 43; 132; 5; 271; 139 
1; 44; 135; 5; 277; 142 
1; 45; 138; 5; 283; 145 
1; 46; 141; 5; 289; 148 
1; 47; 144; 5; 295; 151 
1; 48; 147; 5; 301; 154 
1; 49; 150; 5; 307; 157 
1; 50; 153; 5; 313; 160 
1; 51; 156; 5; 319; 163 
1; 52; 159; 5; 325; 166 
1; 53; 162; 5; 331; 169 
1; 54; 165; 5; 337; 172 
1; 55; 168; 5; 343; 175 
1; 56; 171; 5; 349; 178 
1; 57; 174; 5; 355; 181 
1; 58; 177; 5; 361; 184 
1; 59; 180; 5; 367; 187 
1; 60; 183; 5; 373; 190 
1; 61; 186; 5; 379; 193 
1; 62; 189; 5; 385; 196 
1; 63; 192; 5; 391; 199 
1; 64; 195; 5; 397; 202 
1; 65; 198; 5; 403; 205 
1; 66; 201; 5; 409; 208 
1; 67; 204; 5; 415; 211 
1; 68; 207; 5; 421; 214 
1; 69; 210; 5; 427; 217 
1; 70; 213; 5; 433; 220 
1; 71; 216; 5; 439; 223 
1; 72; 219; 5; 445; 226 
1; 73; 222; 5; 451; 229 
1; 74; 225; 5; 457; 232 
1; 75; 228; 5; 463; 235 
1; 76; 231; 5; 469; 238 
1; 77; 234; 5; 475; 241 
1; 78; 237; 5; 481; 244 
1; 79; 240; 5; 487; 247 
1; 80; 243; 5; 493; 250 
1; 81; 246; 5; 499; 253 
1; 82; 249; 5; 505; 256 
1; 83; 252; 5; 511; 259 
1; 84; 255; 5; 517; 262 
1; 85; 258; 5; 523; 265 
1; 86; 261; 5; 529; 268 
1; 87; 264; 5; 535; 271 
1; 88; 267; 5; 541; 274 
1; 89; 270; 5; 547; 277 
1; 90; 273; 5; 553; 280 
1; 91; 276; 5; 559; 283 
1; 92; 279; 5; 565; 286 
1; 93; 282; 5; 571; 289 
1; 94; 285; 5; 577; 292 
1; 95; 288; 5; 583; 295 
1; 96; 291; 5; 589; 298 
1; 97; 294; 5; 595; 301 
1; 98; 297; 5; 601; 304 
1; 99; 300; 5; 607; 307 
1; 100; 303; 5; 613; 310 
1; 101; 306; 5; 619; 313 
1; 102; 309; 5; 625; 316 
1; 103; 312; 5; 631; 319 
1; 104; 315; 5; 637; 322 
1; 105; 318; 5; 643; 325 
1; 106; 321; 5; 649; 328 
1; 107; 324; 5; 655; 331 
1; 108; 327; 5; 661; 334 
1; 109; 330; 5; 667; 337 
1; 110; 333; 5; 673; 340 
1; 111; 336; 5; 679; 343 
1; 112; 339; 5; 685; 346 
1; 113; 342; 5; 691; 349 
1; 114; 345; 5; 697; 352 
1; 115; 348; 5; 703; 355 
1; 116; 351; 5; 709; 358 
1; 117; 354; 5; 715; 361 
1; 118; 357; 5; 721; 364 
1; 119; 360; 5; 727; 367 
1; 120; 363; 5; 733; 370 
1; 121; 366; 5; 739; 373 
1; 122; 369; 5; 745; 376 
1; 123; 372; 5; 751; 379 
1; 124; 375; 5; 757; 382 
1; 125; 378; 5; 763; 385 
1; 126; 381; 5; 769; 388 
1; 127; 384; 5; 775; 391 
1; 128; 387; 5; 781; 394 
1; 129; 390; 5; 787; 397 
1; 130; 393; 5; 793; 400 
1; 131; 396; 5; 799; 403 
1; 132; 399; 5; 805; 406 
1; 133; 402; 5; 811; 409 
1; 134; 405; 5; 817; 412 
1; 135; 408; 5; 823; 415 
1; 136; 411; 5; 829; 418 
1; 137; 414; 5; 835; 421 
1; 138; 417; 5; 841; 424 
1; 139; 420; 5; 847; 427 
1; 140; 423; 5; 853; 430 
1; 141; 426; 5; 859; 433 
1; 142; 429; 5; 865; 436 
1; 143; 432; 5; 871; 439 
1; 144; 435; 5; 877; 442 
1; 145; 438; 5; 883; 445 
1; 146; 441; 5; 889; 448 
1; 147; 444; 5; 895; 451 
1; 148; 447; 5; 901; 454 
1; 149; 450; 5; 907; 457 
1; 150; 453; 5; 913; 460 
1; 151; 456; 5; 919; 463 
1; 152; 459; 5; 925; 466 
1; 153; 462; 5; 931; 469 
1; 154; 465; 5; 937; 472 
1; 155; 468; 5; 943; 475 
1; 156; 471; 5; 949; 478 
1; 157; 474; 5; 955; 481 
1; 158; 477; 5; 961; 484 
1; 159; 480; 5; 967; 487 
1; 160; 483; 5; 973; 490 
1; 161; 486; 5; 979; 493 
1; 162; 489; 5; 985; 496 
1; 163; 492; 5; 991; 499 
1; 164; 495; 5; 997; 502 
1; 165; 498; 5; 1003; 505 
1; 166; 501; 5; 1009; 508 
1; 167; 504; 5; 1015; 511 
1; 168; 507; 5; 1021; 514 
1; 169; 510; 5; 1027; 517 
1; 170; 513; 5; 1033; 520 
1; 171; 516; 5; 1039; 523 
1; 172; 519; 5; 1045; 526 
1; 173; 522; 5; 1051; 529 
1; 174; 525; 5; 1057; 532 
1; 175; 528; 5; 1063; 535 
1; 176; 531; 5; 1069; 538 
1; 177; 534; 5; 1075; 541 
1; 178; 537; 5; 1081; 544 
1; 179; 540; 5; 1087; 547 
1; 180; 543; 5; 1093; 550 
1; 181; 546; 5; 1099; 553 
1; 182; 549; 5; 1105; 556 
1; 183; 552; 5; 1111; 559 
1; 184; 555; 5; 1117; 562 
1; 185; 558; 5; 1123; 565 
1; 186; 561; 5; 1129; 568 
1; 187; 564; 5; 1135; 571 
1; 188; 567; 5; 1141; 574 
1; 189; 570; 5; 1147; 577 
1; 190; 573; 5; 1153; 580 
1; 191; 576; 5; 1159; 583 
1; 192; 579; 5; 1165; 586 
1; 193; 582; 5; 1171; 589 
1; 194; 585; 5; 1177; 592 
1; 195; 588; 5; 1183; 595 
1; 196; 591; 5; 1189; 598 
1; 197; 594; 5; 1195; 601 
1; 198; 597; 5; 1201; 604 
1; 199; 600; 5; 1207; 607 
1; 200; 603; 5; 1213; 610 
1; 201; 606; 5; 1219; 613 
1; 202; 609; 5; 1225; 616 
1; 203; 612; 5; 1231; 619 
1; 204; 615; 5; 1237; 622 
1; 205; 618; 5; 1243; 625 
1; 206; 621; 5; 1249; 628 
1; 207; 624; 5; 1255; 631 
1; 208; 627; 5; 1261; 634 
1; 209; 630; 5; 1267; 637 
1; 210; 633; 5; 1273; 640 
1; 211; 636; 5; 1279; 643 
1; 212; 639; 5; 1285; 646 
1; 213; 642; 5; 1291; 649 
1; 214; 645; 5; 1297; 652 
1; 215; 648; 5; 1303; 655 
1; 216; 651; 5; 1309; 658 
1; 217; 654; 5; 1315; 661 
1; 218; 657; 5; 1321; 664 
1; 219; 660; 5; 1327; 667 
1; 220; 663; 5; 1333; 670 
1; 221; 666; 5; 1339; 673 
1; 222; 669; 5; 1345; 676 
1; 223; 672; 5; 1351; 679 
1; 224; 675; 5; 1357; 682 
1; 225; 678; 5; 1363; 685 
1; 226; 681; 5; 1369; 688 
1; 227; 684; 5; 1375; 691 
1; 228; 687; 5; 1381; 694 
1; 229; 690; 5; 1387; 697 
1; 230; 693; 5; 1393; 700 
1; 231; 696; 5; 1399; 703 
1; 232; 699; 5; 1405; 706 
1; 233; 702; 5; 1411; 709 
1; 234; 705; 5; 1417; 712 
1; 235; 708; 5; 1423; 715 
1; 236; 711; 5; 1429; 718 
1; 237; 714; 5; 1435; 721 
1; 238; 717; 5; 1441; 724 
1; 239; 720; 5; 1447; 727 
1; 240; 723; 5; 1453; 730 
1; 241; 726; 5; 1459; 733 
1; 242; 729; 5; 1465; 736 
1; 243; 732; 5; 1471; 739 
1; 244; 735; 5; 1477; 742 
1; 245; 738; 5; 1483; 745 
1; 246; 741; 5; 1489; 748 
1; 247; 744; 5; 1495; 751 
1; 248; 747; 5; 1501; 754 
1; 249; 750; 5; 1507; 757 
1; 250; 753; 5; 1513; 760 
1; 251; 756; 5; 1519; 763 
1; 252; 759; 5; 1525; 766 
1; 253; 762; 5; 1531; 769 
1; 254; 765; 5; 1537; 772 
1; 255; 768; 5; 1543; 775 
1; 256; 771; 5; 1549; 778 
1; 257; 774; 5; 1555; 781 
1; 258; 777; 5; 1561; 784 
1; 259; 780; 5; 1567; 787 
1; 260; 783; 5; 1573; 790 
1; 261; 786; 5; 1579; 793 
1; 262; 789; 5; 1585; 796 
1; 263; 792; 5; 1591; 799 
1; 264; 795; 5; 1597; 802 
1; 265; 798; 5; 1603; 805 
1; 266; 801; 5; 1609; 808 
1; 267; 804; 5; 1615; 811 
1; 268; 807; 5; 1621; 814 
1; 269; 810; 5; 1627; 817 
1; 270; 813; 5; 1633; 820 
1; 271; 816; 5; 1639; 823 
1; 272; 819; 5; 1645; 826 
1; 273; 822; 5; 1651; 829 
1; 274; 825; 5; 1657; 832 
1; 275; 828; 5; 1663; 835 
1; 276; 831; 5; 1669; 838 
1; 277; 834; 5; 1675; 841 
1; 278; 837; 5; 1681; 844 
1; 279; 840; 5; 1687; 847 
1; 280; 843; 5; 1693; 850 
1; 281; 846; 5; 1699; 853 
1; 282; 849; 5; 1705; 856 
1; 283; 852; 5; 1711; 859 
1; 284; 855; 5; 1717; 862 
1; 285; 858; 5; 1723; 865 
1; 286; 861; 5; 1729; 868 
1; 287; 864; 5; 1735; 871 
1; 288; 867; 5; 1741; 874 
1; 289; 870; 5; 1747; 877 
1; 290; 873; 5; 1753; 880 
1; 291; 876; 5; 1759; 883 
1; 292; 879; 5; 1765; 886 
1; 293; 882; 5; 1771; 889 
1; 294; 885; 5; 1777; 892 
1; 295; 888; 5; 1783; 895 
1; 296; 891; 5; 1789; 898 
1; 297; 894; 5; 1795; 901 
1; 298; 897; 5; 1801; 904 
1; 299; 900; 5; 1807; 907 
1; 300; 903; 5; 1813; 910 
1; 301; 906; 5; 1819; 913 
1; 302; 909; 5; 1825; 916 
1; 303; 912; 5; 1831; 919 
1; 304; 915; 5; 1837; 922 
1; 305; 918; 5; 1843; 925 
1; 306; 921; 5; 1849; 928 
1; 307; 924; 5; 1855; 931 
1; 308; 927; 5; 1861; 934 
1; 309; 930; 5; 1867; 937 
1; 310; 933; 5; 1873; 940 
1; 311; 936; 5; 1879; 943 
1; 312; 939; 5; 1885; 946 
1; 313; 942; 5; 1891; 949 
1; 314; 945; 5; 1897; 952 
1; 315; 948; 5; 1903; 955 
1; 316; 951; 5; 1909; 958 
1; 317; 954; 5; 1915; 961 
1; 318; 957; 5; 1921; 964 
1; 319; 960; 5; 1927; 967 
1; 320; 963; 5; 1933; 970 
1; 321; 966; 5; 1939; 973 
1; 322; 969; 5; 1945; 976 
1; 323; 972; 5; 1951; 979 
1; 324; 975; 5; 1957; 982 
1; 325; 978; 5; 1963; 985 
1; 326; 981; 5; 1969; 988 
1; 327; 984; 5; 1975; 991 
1; 328; 987; 5; 1981; 994 
1; 329; 990; 5; 1987; 997 
1; 330; 993; 5; 1993; 1000 
1; 331; 996; 5; 1999; 1003 
1; 332; 999; 5; 2005; 1006 
1; 333; 1002; 5; 2011; 1009 
1; 334; 1005; 5; 2017; 1012 
1; 335; 1008; 5; 2023; 1015 
1; 336; 1011; 5; 2029; 1018 
1; 337; 1014; 5; 2035; 1021 
1; 338; 1017; 5; 2041; 1024 
1; 339; 1020; 5; 2047; 1027 
1; 340; 1023; 5; 2053; 1030 
1; 341; 1026; 5; 2059; 1033 
1; 342; 1029; 5; 2065; 1036 
1; 343; 1032; 5; 2071; 1039 
1; 344; 1035; 5; 2077; 1042 
1; 345; 1038; 5; 2083; 1045 
1; 346; 1041; 5; 2089; 1048 
1; 347; 1044; 5; 2095; 1051 
1; 348; 1047; 5; 2101; 1054 
1; 349; 1050; 5; 2107; 1057 
1; 350; 1053; 5; 2113; 1060 
1; 351; 1056; 5; 2119; 1063 
1; 352; 1059; 5; 2125; 1066 
1; 353; 1062; 5; 2131; 1069 
1; 354; 1065; 5; 2137; 1072 
1; 355; 1068; 5; 2143; 1075 
1; 356; 1071; 5; 2149; 1078 
1; 357; 1074; 5; 2155; 1081 
1; 358; 1077; 5; 2161; 1084 
1; 359; 1080; 5; 2167; 1087 
1; 360; 1083; 5; 2173; 1090 
1; 361; 1086; 5; 2179; 1093 
1; 362; 1089; 5; 2185; 1096 
1; 363; 1092; 5; 2191; 1099 
1; 364; 1095; 5; 2197; 1102 
1; 365; 1098; 5; 2203; 1105 
1; 366; 1101; 5; 2209; 1108 
1; 367; 1104; 5; 2215; 1111 
1; 368; 1107; 5; 2221; 1114 
1; 369; 1110; 5; 2227; 1117 
1; 370; 1113; 5; 2233; 1120 
1; 371; 1116; 5; 2239; 1123 
1; 372; 1119; 5; 2245; 1126 
1; 373; 1122; 5; 2251; 1129 
1; 374; 1125; 5; 2257; 1132 
1; 375; 1128; 5; 2263; 1135 
1; 376; 1131; 5; 2269; 1138 
1; 377; 1134; 5; 2275; 1141 
1; 378; 1137; 5; 2281; 1144 
1; 379; 1140; 5; 2287; 1147 
1; 380; 1143; 5; 2293; 1150 
1; 381; 1146; 5; 2299; 1153 
1; 382; 1149; 5; 2305; 1156 
1; 383; 1152; 5; 2311; 1159 
1; 384; 1155; 5; 2317; 1162 
1; 385; 1158; 5; 2323; 1165 
1; 386; 1161; 5; 2329; 1168 
1; 387; 1164; 5; 2335; 1171 
1; 388; 1167; 5; 2341; 1174 
1; 389; 1170; 5; 2347; 1177 
1; 390; 1173; 5; 2353; 1180 
1; 391; 1176; 5; 2359; 1183 
1; 392; 1179; 5; 2365; 1186 
1; 393; 1182; 5; 2371; 1189 
1; 394; 1185; 5; 2377; 1192 
1; 395; 1188; 5; 2383; 1195 
1; 396; 1191; 5; 2389; 1198 
1; 397; 1194; 5; 2395; 1201 
1; 398; 1197; 5; 2401; 1204 
1; 399; 1200; 5; 2407; 1207 
1; 400; 1203; 5; 2413; 1210 
1; 401; 1206; 5; 2419; 1213 
1; 402; 1209; 5; 2425; 1216 
1; 403; 1212; 5; 2431; 1219 
1; 404; 1215; 5; 2437; 1222 
1; 405; 1218; 5; 2443; 1225 
1; 406; 1221; 5; 2449; 1228 
1; 407; 1224; 5; 2455; 1231 
1; 408; 1227; 5; 2461; 1234 
1; 409; 1230; 5; 2467; 1237 
1; 410; 1233; 5; 2473; 1240 
1; 411; 1236; 5; 2479; 1243 
1; 412; 1239; 5; 2485; 1246 
1; 413; 1242; 5; 2491; 1249 
1; 414; 1245; 5; 2497; 1252 
1; 415; 1248; 5; 2503; 1255 
1; 416; 1251; 5; 2509; 1258 
1; 417; 1254; 5; 2515; 1261 
1; 418; 1257; 5; 2521; 1264 
1; 419; 1260; 5; 2527; 1267 
1; 420; 1263; 5; 2533; 1270 
1; 421; 1266; 5; 2539; 1273 
1; 422; 1269; 5; 2545; 1276 
1; 423; 1272; 5; 2551; 1279 
1; 424; 1275; 5; 2557; 1282 
1; 425; 1278; 5; 2563; 1285 
1; 426; 1281; 5; 2569; 1288 
1; 427; 1284; 5; 2575; 1291 
1; 428; 1287; 5; 2581; 1294 
1; 429; 1290; 5; 2587; 1297 
1; 430; 1293; 5; 2593; 1300 
1; 431; 1296; 5; 2599; 1303 
1; 432; 1299; 5; 2605; 1306 
1; 433; 1302; 5; 2611; 1309 
1; 434; 1305; 5; 2617; 1312 
1; 435; 1308; 5; 2623; 1315 
1; 436; 1311; 5; 2629; 1318 
1; 437; 1314; 5; 2635; 1321 
1; 438; 1317; 5; 2641; 1324 
1; 439; 1320; 5; 2647; 1327 
1; 440; 1323; 5; 2653; 1330 
1; 441; 1326; 5; 2659; 1333 
1; 442; 1329; 5; 2665; 1336 
1; 443; 1332; 5; 2671; 1339 
1; 444; 1335; 5; 2677; 1342 
1; 445; 1338; 5; 2683; 1345 
1; 446; 1341; 5; 2689; 1348 
1; 447; 1344; 5; 2695; 1351 
1; 448; 1347; 5; 2701; 1354 
1; 449; 1350; 5; 2707; 1357 
1; 450; 1353; 5; 2713; 1360 
1; 451; 1356; 5; 2719; 1363 
1; 452; 1359; 5; 2725; 1366 
1; 453; 1362; 5; 2731; 1369 
1; 454; 1365; 5; 2737; 1372 
1; 455; 1368; 5; 2743; 1375 
1; 456; 1371; 5; 2749; 1378 
1; 457; 1374; 5; 2755; 1381 
1; 458; 1377; 5; 2761; 1384 
1; 459; 1380; 5; 2767; 1387 
1; 460; 1383; 5; 2773; 1390 
1; 461; 1386; 5; 2779; 1393 
1; 462; 1389; 5; 2785; 1396 
1; 463; 1392; 5; 2791; 1399 
1; 464; 1395; 5; 2797; 1402 
1; 465; 1398; 5; 2803; 1405 
1; 466; 1401; 5; 2809; 1408 
1; 467; 1404; 5; 2815; 1411 
1; 468; 1407; 5; 2821; 1414 
1; 469; 1410; 5; 2827; 1417 
1; 470; 1413; 5; 2833; 1420 
1; 471; 1416; 5; 2839; 1423 
1; 472; 1419; 5; 2845; 1426 
1; 473; 1422; 5; 2851; 1429 
1; 474; 1425; 5; 2857; 1432 
1; 475; 1428; 5; 2863; 1435 
1; 476; 1431; 5; 2869; 1438 
1; 477; 1434; 5; 2875; 1441 
1; 478; 1437; 5; 2881; 1444 
1; 479; 1440; 5; 2887; 1447 
1; 480; 1443; 5; 2893; 1450 
1; 481; 1446; 5; 2899; 1453 
1; 482; 1449; 5; 2905; 1456 
1; 483; 1452; 5; 2911; 1459 
1; 484; 1455; 5; 2917; 1462 
1; 485; 1458; 5; 2923; 1465 
1; 486; 1461; 5; 2929; 1468 
1; 487; 1464; 5; 2935; 1471 
1; 488; 1467; 5; 2941; 1474 
1; 489; 1470; 5; 2947; 1477 
1; 490; 1473; 5; 2953; 1480 
1; 491; 1476; 5; 2959; 1483 
1; 492; 1479; 5; 2965; 1486 
1; 493; 1482; 5; 2971; 1489 
1; 494; 1485; 5; 2977; 1492 
1; 495; 1488; 5; 2983; 1495 
1; 496; 1491; 5; 2989; 1498 
1; 497; 1494; 5; 2995; 1501 
1; 498; 1497; 5; 3001; 1504 
1; 499; 1500; 5; 3007; 1507 
1; 500; 1503; 5; 3013; 1510 
1; 501; 1506; 5; 3019; 1513 
1; 502; 1509; 5; 3025; 1516 
1; 503; 1512; 5; 3031; 1519 
1; 504; 1515; 5; 3037; 1522 
1; 505; 1518; 5; 3043; 1525 
1; 506; 1521; 5; 3049; 1528 
1; 507; 1524; 5; 3055; 1531 
1; 508; 1527; 5; 3061; 1534 
1; 509; 1530; 5; 3067; 1537 
1; 510; 1533; 5; 3073; 1540 
1; 511; 1536; 5; 3079; 1543 
1; 512; 1539; 5; 3085; 1546 
1; 513; 1542; 5; 3091; 1549 
1; 514; 1545; 5; 3097; 1552 
1; 515; 1548; 5; 3103; 1555 
1; 516; 1551; 5; 3109; 1558 
1; 517; 1554; 5; 3115; 1561 
1; 518; 1557; 5; 3121; 1564 
1; 519; 1560; 5; 3127; 1567 
1; 520; 1563; 5; 3133; 1570 
1; 521; 1566; 5; 3139; 1573 
1; 522; 1569; 5; 3145; 1576 
1; 523; 1572; 5; 3151; 1579 
1; 524; 1575; 5; 3157; 1582 
1; 525; 1578; 5; 3163; 1585 
1; 526; 1581; 5; 3169; 1588 
1; 527; 1584; 5; 3175; 1591 
1; 528; 1587; 5; 3181; 1594 
1; 529; 1590; 5; 3187; 1597 
1; 530; 1593; 5; 3193; 1600 
1; 531; 1596; 5; 3199; 1603 
1; 532; 1599; 5; 3205; 1606 
1; 533; 1602; 5; 3211; 1609 
1; 534; 1605; 5; 3217; 1612 
1; 535; 1608; 5; 3223; 1615 
1; 536; 1611; 5; 3229; 1618 
1; 537; 1614; 5; 3235; 1621 
1; 538; 1617; 5; 3241; 1624 
1; 539; 1620; 5; 3247; 1627 
1; 540; 1623; 5; 3253; 1630 
1; 541; 1626; 5; 3259; 1633 
1; 542; 1629; 5; 3265; 1636 
1; 543; 1632; 5; 3271; 1639 
1; 544; 1635; 5; 3277; 1642 
1; 545; 1638; 5; 3283; 1645 
1; 546; 1641; 5; 3289; 1648 
1; 547; 1644; 5; 3295; 1651 
1; 548; 1647; 5; 3301; 1654 
1; 549; 1650; 5; 3307; 1657 
1; 550; 1653; 5; 3313; 1660 
1; 551; 1656; 5; 3319; 1663 
1; 552; 1659; 5; 3325; 1666 
1; 553; 1662; 5; 3331; 1669 
1; 554; 1665; 5; 3337; 1672 
1; 555; 1668; 5; 3343; 1675 
1; 556; 1671; 5; 3349; 1678 
1; 557; 1674; 5; 3355; 1681 
1; 558; 1677; 5; 3361; 1684 
1; 559; 1680; 5; 3367; 1687 
1; 560; 1683; 5; 3373; 1690 
1; 561; 1686; 5; 3379; 1693 
1; 562; 1689; 5; 3385; 1696 
1; 563; 1692; 5; 3391; 1699 
1; 564; 1695; 5; 3397; 1702 
1; 565; 1698; 5; 3403; 1705 
1; 566; 1701; 5; 3409; 1708 
1; 567; 1704; 5; 3415; 1711 
1; 568; 1707; 5; 3421; 1714 
1; 569; 1710; 5; 3427; 1717 
1; 570; 1713; 5; 3433; 1720 
1; 571; 1716; 5; 3439; 1723 
1; 572; 1719; 5; 3445; 1726 
1; 573; 1722; 5; 3451; 1729 
1; 574; 1725; 5; 3457; 1732 
1; 575; 1728; 5; 3463; 1735 
1; 576; 1731; 5; 3469; 1738 
1; 577; 1734; 5; 3475; 1741 
1; 578; 1737; 5; 3481; 1744 
1; 579; 1740; 5; 3487; 1747 
1; 580; 1743; 5; 3493; 1750 
1; 581; 1746; 5; 3499; 1753 
1; 582; 1749; 5; 3505; 1756 
1; 583; 1752; 5; 3511; 1759 
1; 584; 1755; 5; 3517; 1762 
1; 585; 1758; 5; 3523; 1765 
1; 586; 1761; 5; 3529; 1768 
1; 587; 1764; 5; 3535; 1771 
1; 588; 1767; 5; 3541; 1774 
1; 589; 1770; 5; 3547; 1777 
1; 590; 1773; 5; 3553; 1780 
1; 591; 1776; 5; 3559; 1783 
1; 592; 1779; 5; 3565; 1786 
1; 593; 1782; 5; 3571; 1789 
1; 594; 1785; 5; 3577; 1792 
1; 595; 1788; 5; 3583; 1795 
1; 596; 1791; 5; 3589; 1798 
1; 597; 1794; 5; 3595; 1801 
1; 598; 1797; 5; 3601; 1804 
1; 599; 1800; 5; 3607; 1807 
1; 600; 1803; 5; 3613; 1810 
1; 601; 1806; 5; 3619; 1813 
1; 602; 1809; 5; 3625; 1816 
1; 603; 1812; 5; 3631; 1819 
1; 604; 1815; 5; 3637; 1822 
1; 605; 1818; 5; 3643; 1825 
1; 606; 1821; 5; 3649; 1828 
1; 607; 1824; 5; 3655; 1831 
1; 608; 1827; 5; 3661; 1834 
1; 609; 1830; 5; 3667; 1837 
1; 610; 1833; 5; 3673; 1840 
1; 611; 1836; 5; 3679; 1843 
1; 612; 1839; 5; 3685; 1846 
1; 613; 1842; 5; 3691; 1849 
1; 614; 1845; 5; 3697; 1852 
1; 615; 1848; 5; 3703; 1855 
1; 616; 1851; 5; 3709; 1858 
1; 617; 1854; 5; 3715; 1861 
1; 618; 1857; 5; 3721; 1864 
1; 619; 1860; 5; 3727; 1867 
1; 620; 1863; 5; 3733; 1870 
1; 621; 1866; 5; 3739; 1873 
1; 622; 1869; 5; 3745; 1876 
1; 623; 1872; 5; 3751; 1879 
1; 624; 1875; 5; 3757; 1882 
1; 625; 1878; 5; 3763; 1885 
1; 626; 1881; 5; 3769; 1888 
1; 627; 1884; 5; 3775; 1891 
1; 628; 1887; 5; 3781; 1894 
1; 629; 1890; 5; 3787; 1897 
1; 630; 1893; 5; 3793; 1900 
1; 631; 1896; 5; 3799; 1903 
1; 632; 1899; 5; 3805; 1906 
1; 633; 1902; 5; 3811; 1909 
1; 634; 1905; 5; 3817; 1912 
1; 635; 1908; 5; 3823; 1915 
1; 636; 1911; 5; 3829; 1918 
1; 637; 1914; 5; 3835; 1921 
1; 638; 1917; 5; 3841; 1924 
1; 639; 1920; 5; 3847; 1927 
1; 640; 1923; 5; 3853; 1930 
1; 641; 1926; 5; 3859; 1933 
1; 642; 1929; 5; 3865; 1936 
1; 643; 1932; 5; 3871; 1939 
1; 644; 1935; 5; 3877; 1942 
1; 645; 1938; 5; 3883; 1945 
1; 646; 1941; 5; 3889; 1948 
1; 647; 1944; 5; 3895; 1951 
1; 648; 1947; 5; 3901; 1954 
1; 649; 1950; 5; 3907; 1957 
1; 650; 1953; 5; 3913; 1960 
1; 651; 1956; 5; 3919; 1963 
1; 652; 1959; 5; 3925; 1966 
1; 653; 1962; 5; 3931; 1969 
1; 654; 1965; 5; 3937; 1972 
1; 655; 1968; 5; 3943; 1975 
1; 656; 1971; 5; 3949; 1978 
1; 657; 1974; 5; 3955; 1981 
1; 658; 1977; 5; 3961; 1984 
1; 659; 1980; 5; 3967; 1987 
1; 660; 1983; 5; 3973; 1990 
1; 661; 1986; 5; 3979; 1993 
1; 662; 1989; 5; 3985; 1996 
1; 663; 1992; 5; 3991; 1999 
1; 664; 1995; 5; 3997; 2002 
1; 665; 1998; 5; 4003; 2005 
1; 666; 2001; 5; 4009; 2008 
1; 667; 2004; 5; 4015; 2011 
1; 668; 2007; 5; 4021; 2014 
1; 669; 2010; 5; 4027; 2017 
1; 670; 2013; 5; 4033; 2020 
1; 671; 2016; 5; 4039; 2023 
1; 672; 2019; 5; 4045; 2026 
1; 673; 2022; 5; 4051; 2029 
1; 674; 2025; 5; 4057; 2032 
1; 675; 2028; 5; 4063; 2035 
1; 676; 2031; 5; 4069; 2038 
1; 677; 2034; 5; 4075; 2041 
1; 678; 2037; 5; 4081; 2044 
1; 679; 2040; 5; 4087; 2047 
1; 680; 2043; 5; 4093; 2050 
1; 681; 2046; 5; 4099; 2053 
1; 682; 2049; 5; 4105; 2056 
1; 683; 2052; 5; 4111; 2059 
1; 684; 2055; 5; 4117; 2062 
1; 685; 2058; 5; 4123; 2065 
1; 686; 2061; 5; 4129; 2068 
1; 687; 2064; 5; 4135; 2071 
1; 688; 2067; 5; 4141; 2074 
1; 689; 2070; 5; 4147; 2077 
1; 690; 2073; 5; 4153; 2080 
1; 691; 2076; 5; 4159; 2083 
1; 692; 2079; 5; 4165; 2086 
1; 693; 2082; 5; 4171; 2089 
1; 694; 2085; 5; 4177; 2092 
1; 695; 2088; 5; 4183; 2095 
1; 696; 2091; 5; 4189; 2098 
1; 697; 2094; 5; 4195; 2101 
1; 698; 2097; 5; 4201; 2104 
1; 699; 2100; 5; 4207; 2107 
1; 700; 2103; 5; 4213; 2110 
1; 701; 2106; 5; 4219; 2113 
1; 702; 2109; 5; 4225; 2116 
1; 703; 2112; 5; 4231; 2119 
1; 704; 2115; 5; 4237; 2122 
1; 705; 2118; 5; 4243; 2125 
1; 706; 2121; 5; 4249; 2128 
1; 707; 2124; 5; 4255; 2131 
1; 708; 2127; 5; 4261; 2134 
1; 709; 2130; 5; 4267; 2137 
1; 710; 2133; 5; 4273; 2140 
1; 711; 2136; 5; 4279; 2143 
1; 712; 2139; 5; 4285; 2146 
1; 713; 2142; 5; 4291; 2149 
1; 714; 2145; 5; 4297; 2152 
1; 715; 2148; 5; 4303; 2155 
1; 716; 2151; 5; 4309; 2158 
1; 717; 2154; 5; 4315; 2161 
1; 718; 2157; 5; 4321; 2164 
1; 719; 2160; 5; 4327; 2167 
1; 720; 2163; 5; 4333; 2170 
1; 721; 2166; 5; 4339; 2173 
1; 722; 2169; 5; 4345; 2176 
1; 723; 2172; 5; 4351; 2179 
1; 724; 2175; 5; 4357; 2182 
1; 725; 2178; 5; 4363; 2185 
1; 726; 2181; 5; 4369; 2188 
1; 727; 2184; 5; 4375; 2191 
1; 728; 2187; 5; 4381; 2194 
1; 729; 2190; 5; 4387; 2197 
1; 730; 2193; 5; 4393; 2200 
1; 731; 2196; 5; 4399; 2203 
1; 732; 2199; 5; 4405; 2206 
1; 733; 2202; 5; 4411; 2209 
1; 734; 2205; 5; 4417; 2212 
1; 735; 2208; 5; 4423; 2215 
1; 736; 2211; 5; 4429; 2218 
1; 737; 2214; 5; 4435; 2221 
1; 738; 2217; 5; 4441; 2224 
1; 739; 2220; 5; 4447; 2227 
1; 740; 2223; 5; 4453; 2230 
1; 741; 2226; 5; 4459; 2233 
1; 742; 2229; 5; 4465; 2236 
1; 743; 2232; 5; 4471; 2239 
1; 744; 2235; 5; 4477; 2242 
1; 745; 2238; 5; 4483; 2245 
1; 746; 2241; 5; 4489; 2248 
1; 747; 2244; 5; 4495; 2251 
1; 748; 2247; 5; 4501; 2254 
1; 749; 2250; 5; 4507; 2257 
1; 750; 2253; 5; 4513; 2260 
1; 751; 2256; 5; 4519; 2263 
1; 752; 2259; 5; 4525; 2266 
1; 753; 2262; 5; 4531; 2269 
1; 754; 2265; 5; 4537; 2272 
1; 755; 2268; 5; 4543; 2275 
1; 756; 2271; 5; 4549; 2278 
1; 757; 2274; 5; 4555; 2281 
1; 758; 2277; 5; 4561; 2284 
1; 759; 2280; 5; 4567; 2287 
1; 760; 2283; 5; 4573; 2290 
1; 761; 2286; 5; 4579; 2293 
1; 762; 2289; 5; 4585; 2296 
1; 763; 2292; 5; 4591; 2299 
1; 764; 2295; 5; 4597; 2302 
1; 765; 2298; 5; 4603; 2305 
1; 766; 2301; 5; 4609; 2308 
1; 767; 2304; 5; 4615; 2311 
1; 768; 2307; 5; 4621; 2314 
1; 769; 2310; 5; 4627; 2317 
1; 770; 2313; 5; 4633; 2320 
1; 771; 2316; 5; 4639; 2323 
1; 772; 2319; 5; 4645; 2326 
1; 773; 2322; 5; 4651; 2329 
1; 774; 2325; 5; 4657; 2332 
1; 775; 2328; 5; 4663; 2335 
1; 776; 2331; 5; 4669; 2338 
1; 777; 2334; 5; 4675; 2341 
1; 778; 2337; 5; 4681; 2344 
1; 779; 2340; 5; 4687; 2347 
1; 780; 2343; 5; 4693; 2350 
1; 781; 2346; 5; 4699; 2353 
1; 782; 2349; 5; 4705; 2356 
1; 783; 2352; 5; 4711; 2359 
1; 784; 2355; 5; 4717; 2362 
1; 785; 2358; 5; 4723; 2365 
1; 786; 2361; 5; 4729; 2368 
1; 787; 2364; 5; 4735; 2371 
1; 788; 2367; 5; 4741; 2374 
1; 789; 2370; 5; 4747; 2377 
1; 790; 2373; 5; 4753; 2380 
1; 791; 2376; 5; 4759; 2383 
1; 792; 2379; 5; 4765; 2386 
1; 793; 2382; 5; 4771; 2389 
1; 794; 2385; 5; 4777; 2392 
1; 795; 2388; 5; 4783; 2395 
1; 796; 2391; 5; 4789; 2398 
1; 797; 2394; 5; 4795; 2401 
1; 798; 2397; 5; 4801; 2404 
1; 799; 2400; 5; 4807; 2407 
1; 800; 2403; 5; 4813; 2410 
1; 801; 2406; 5; 4819; 2413 
1; 802; 2409; 5; 4825; 2416 
1; 803; 2412; 5; 4831; 2419 
1; 804; 2415; 5; 4837; 2422 
1; 805; 2418; 5; 4843; 2425 
1; 806; 2421; 5; 4849; 2428 
1; 807; 2424; 5; 4855; 2431 
1; 808; 2427; 5; 4861; 2434 
1; 809; 2430; 5; 4867; 2437 
1; 810; 2433; 5; 4873; 2440 
1; 811; 2436; 5; 4879; 2443 
1; 812; 2439; 5; 4885; 2446 
1; 813; 2442; 5; 4891; 2449 
1; 814; 2445; 5; 4897; 2452 
1; 815; 2448; 5; 4903; 2455 
1; 816; 2451; 5; 4909; 2458 
1; 817; 2454; 5; 4915; 2461 
1; 818; 2457; 5; 4921; 2464 
1; 819; 2460; 5; 4927; 2467 
1; 820; 2463; 5; 4933; 2470 
1; 821; 2466; 5; 4939; 2473 
1; 822; 2469; 5; 4945; 2476 
1; 823; 2472; 5; 4951; 2479 
1; 824; 2475; 5; 4957; 2482 
1; 825; 2478; 5; 4963; 2485 
1; 826; 2481; 5; 4969; 2488 
1; 827; 2484; 5; 4975; 2491 
1; 828; 2487; 5; 4981; 2494 
1; 829; 2490; 5; 4987; 2497 
1; 830; 2493; 5; 4993; 2500 
1; 831; 2496; 5; 4999; 2503 
1; 832; 2499; 5; 5005; 2506 
1; 833; 2502; 5; 5011; 2509 
1; 834; 2505; 5; 5017; 2512 
1; 835; 2508; 5; 5023; 2515 
1; 836; 2511; 5; 5029; 2518 
1; 837; 2514; 5; 5035; 2521 
1; 838; 2517; 5; 5041; 2524 
1; 839; 2520; 5; 5047; 2527 
1; 840; 2523; 5; 5053; 2530 
1; 841; 2526; 5; 5059; 2533 
1; 842; 2529; 5; 5065; 2536 
1; 843; 2532; 5; 5071; 2539 
1; 844; 2535; 5; 5077; 2542 
1; 845; 2538; 5; 5083; 2545 
1; 846; 2541; 5; 5089; 2548 
1; 847; 2544; 5; 5095; 2551 
1; 848; 2547; 5; 5101; 2554 
1; 849; 2550; 5; 5107; 2557 
1; 850; 2553; 5; 5113; 2560 
1; 851; 2556; 5; 5119; 2563 
1; 852; 2559; 5; 5125; 2566 
1; 853; 2562; 5; 5131; 2569 
1; 854; 2565; 5; 5137; 2572 
1; 855; 2568; 5; 5143; 2575 
1; 856; 2571; 5; 5149; 2578 
1; 857; 2574; 5; 5155; 2581 
1; 858; 2577; 5; 5161; 2584 
1; 859; 2580; 5; 5167; 2587 
1; 860; 2583; 5; 5173; 2590 
1; 861; 2586; 5; 5179; 2593 
1; 862; 2589; 5; 5185; 2596 
1; 863; 2592; 5; 5191; 2599 
1; 864; 2595; 5; 5197; 2602 
1; 865; 2598; 5; 5203; 2605 
1; 866; 2601; 5; 5209; 2608 
1; 867; 2604; 5; 5215; 2611 
1; 868; 2607; 5; 5221; 2614 
1; 869; 2610; 5; 5227; 2617 
1; 870; 2613; 5; 5233; 2620 
1; 871; 2616; 5; 5239; 2623 
1; 872; 2619; 5; 5245; 2626 
1; 873; 2622; 5; 5251; 2629 
1; 874; 2625; 5; 5257; 2632 
1; 875; 2628; 5; 5263; 2635 
1; 876; 2631; 5; 5269; 2638 
1; 877; 2634; 5; 5275; 2641 
1; 878; 2637; 5; 5281; 2644 
1; 879; 2640; 5; 5287; 2647 
1; 880; 2643; 5; 5293; 2650 
1; 881; 2646; 5; 5299; 2653 
1; 882; 2649; 5; 5305; 2656 
1; 883; 2652; 5; 5311; 2659 
1; 884; 2655; 5; 5317; 2662 
1; 885; 2658; 5; 5323; 2665 
1; 886; 2661; 5; 5329; 2668 
1; 887; 2664; 5; 5335; 2671 
1; 888; 2667; 5; 5341; 2674 
1; 889; 2670; 5; 5347; 2677 
1; 890; 2673; 5; 5353; 2680 
1; 891; 2676; 5; 5359; 2683 
1; 892; 2679; 5; 5365; 2686 
1; 893; 2682; 5; 5371; 2689 
1; 894; 2685; 5; 5377; 2692 
1; 895; 2688; 5; 5383; 2695 
1; 896; 2691; 5; 5389; 2698 
1; 897; 2694; 5; 5395; 2701 
1; 898; 2697; 5; 5401; 2704 
1; 899; 2700; 5; 5407; 2707 
1; 900; 2703; 5; 5413; 2710 
1; 901; 2706; 5; 5419; 2713 
1; 902; 2709; 5; 5425; 2716 
1; 903; 2712; 5; 5431; 2719 
1; 904; 2715; 5; 5437; 2722 
1; 905; 2718; 5; 5443; 2725 
1; 906; 2721; 5; 5449; 2728 
1; 907; 2724; 5; 5455; 2731 
1; 908; 2727; 5; 5461; 2734 
1; 909; 2730; 5; 5467; 2737 
1; 910; 2733; 5; 5473; 2740 
1; 911; 2736; 5; 5479; 2743 
1; 912; 2739; 5; 5485; 2746 
1; 913; 2742; 5; 5491; 2749 
1; 914; 2745; 5; 5497; 2752 
1; 915; 2748; 5; 5503; 2755 
1; 916; 2751; 5; 5509; 2758 
1; 917; 2754; 5; 5515; 2761 
1; 918; 2757; 5; 5521; 2764 
1; 919; 2760; 5; 5527; 2767 
1; 920; 2763; 5; 5533; 2770 
1; 921; 2766; 5; 5539; 2773 
1; 922; 2769; 5; 5545; 2776 
1; 923; 2772; 5; 5551; 2779 
1; 924; 2775; 5; 5557; 2782 
1; 925; 2778; 5; 5563; 2785 
1; 926; 2781; 5; 5569; 2788 
1; 927; 2784; 5; 5575; 2791 
1; 928; 2787; 5; 5581; 2794 
1; 929; 2790; 5; 5587; 2797 
1; 930; 2793; 5; 5593; 2800 
1; 931; 2796; 5; 5599; 2803 
1; 932; 2799; 5; 5605; 2806 
1; 933; 2802; 5; 5611; 2809 
1; 934; 2805; 5; 5617; 2812 
1; 935; 2808; 5; 5623; 2815 
1; 936; 2811; 5; 5629; 2818 
1; 937; 2814; 5; 5635; 2821 
1; 938; 2817; 5; 5641; 2824 
1; 939; 2820; 5; 5647; 2827 
1; 940; 2823; 5; 5653; 2830 
1; 941; 2826; 5; 5659; 2833 
1; 942; 2829; 5; 5665; 2836 
1; 943; 2832; 5; 5671; 2839 
1; 944; 2835; 5; 5677; 2842 
1; 945; 2838; 5; 5683; 2845 
1; 946; 2841; 5; 5689; 2848 
1; 947; 2844; 5; 5695; 2851 
1; 948; 2847; 5; 5701; 2854 
1; 949; 2850; 5; 5707; 2857 
1; 950; 2853; 5; 5713; 2860 
1; 951; 2856; 5; 5719; 2863 
1; 952; 2859; 5; 5725; 2866 
1; 953; 2862; 5; 5731; 2869 
1; 954; 2865; 5; 5737; 2872 
1; 955; 2868; 5; 5743; 2875 
1; 956; 2871; 5; 5749; 2878 
1; 957; 2874; 5; 5755; 2881 
1; 958; 2877; 5; 5761; 2884 
1; 959; 2880; 5; 5767; 2887 
1; 960; 2883; 5; 5773; 2890 
1; 961; 2886; 5; 5779; 2893 
1; 962; 2889; 5; 5785; 2896 
1; 963; 2892; 5; 5791; 2899 
1; 964; 2895; 5; 5797; 2902 
1; 965; 2898; 5; 5803; 2905 
1; 966; 2901; 5; 5809; 2908 
1; 967; 2904; 5; 5815; 2911 
1; 968; 2907; 5; 5821; 2914 
1; 969; 2910; 5; 5827; 2917 
1; 970; 2913; 5; 5833; 2920 
1; 971; 2916; 5; 5839; 2923 
1; 972; 2919; 5; 5845; 2926 
1; 973; 2922; 5; 5851; 2929 
1; 974; 2925; 5; 5857; 2932 
1; 975; 2928; 5; 5863; 2935 
1; 976; 2931; 5; 5869; 2938 
1; 977; 2934; 5; 5875; 2941 
1; 978; 2937; 5; 5881; 2944 
1; 979; 2940; 5; 5887; 2947 
1; 980; 2943; 5; 5893; 2950 
1; 981; 2946; 5; 5899; 2953 
1; 982; 2949; 5; 5905; 2956 
1; 983; 2952; 5; 5911; 2959 
1; 984; 2955; 5; 5917; 2962 
1; 985; 2958; 5; 5923; 2965 
1; 986; 2961; 5; 5929; 2968 
1; 987; 2964; 5; 5935; 2971 
1; 988; 2967; 5; 5941; 2974 
1; 989; 2970; 5; 5947; 2977 
1; 990; 2973; 5; 5953; 2980 
1; 991; 2976; 5; 5959; 2983 
1; 992; 2979; 5; 5965; 2986 
1; 993; 2982; 5; 5971; 2989 
1; 994; 2985; 5; 5977; 2992 
1; 995; 2988; 5; 5983; 2995 
1; 996; 2991; 5; 5989; 2998 
1; 997; 2994; 5; 5995; 3001 
1; 998; 2997; 5; 6001; 3004 
1; 999; 3000; 5; 6007; 3007 
1; 1000; 3003; 5; 6013; 3010 
1; 1001; 3006; 5; 6019; 3013 
1; 1002; 3009; 5; 6025; 3016 
1; 1003; 3012; 5; 6031; 3019 
1; 1004; 3015; 5; 6037; 3022 
1; 1005; 3018; 5; 6043; 3025 
1; 1006; 3021; 5; 6049; 3028 
1; 1007; 3024; 5; 6055; 3031 
1; 1008; 3027; 5; 6061; 3034 
1; 1009; 3030; 5; 6067; 3037 
1; 1010; 3033; 5; 6073; 3040 
1; 1011; 3036; 5; 6079; 3043 
1; 1012; 3039; 5; 6085; 3046 
1; 1013; 3042; 5; 6091; 3049 
1; 1014; 3045; 5; 6097; 3052 
1; 1015; 3048; 5; 6103; 3055 
1; 1016; 3051; 5; 6109; 3058 
1; 1017; 3054; 5; 6115; 3061 
1; 1018; 3057; 5; 6121; 3064 
1; 1019; 3060; 5; 6127; 3067 
1; 1020; 3063; 5; 6133; 3070 
1; 1021; 3066; 5; 6139; 3073 
1; 1022; 3069; 5; 6145; 3076 
1; 1023; 3072; 5; 6151; 3079 
1; 1024; 3075; 5; 6157; 3082 
1; 1025; 3078; 5; 6163; 3085 
1; 1026; 3081; 5; 6169; 3088 
1; 1027; 3084; 5; 6175; 3091 
1; 1028; 3087; 5; 6181; 3094 
1; 1029; 3090; 5; 6187; 3097 
1; 1030; 3093; 5; 6193; 3100 
1; 1031; 3096; 5; 6199; 3103 
1; 1032; 3099; 5; 6205; 3106 
1; 1033; 3102; 5; 6211; 3109 
1; 1034; 3105; 5; 6217; 3112 
1; 1035; 3108; 5; 6223; 3115 
1; 1036; 3111; 5; 6229; 3118 
1; 1037; 3114; 5; 6235; 3121 
1; 1038; 3117; 5; 6241; 3124 
1; 1039; 3120; 5; 6247; 3127 
1; 1040; 3123; 5; 6253; 3130 
1; 1041; 3126; 5; 6259; 3133 
1; 1042; 3129; 5; 6265; 3136 
1; 1043; 3132; 5; 6271; 3139 
1; 1044; 3135; 5; 6277; 3142 
1; 1045; 3138; 5; 6283; 3145 
1; 1046; 3141; 5; 6289; 3148 
1; 1047; 3144; 5; 6295; 3151 
1; 1048; 3147; 5; 6301; 3154 
1; 1049; 3150; 5; 6307; 3157 
1; 1050; 3153; 5; 6313; 3160 
1; 1051; 3156; 5; 6319; 3163 
1; 1052; 3159; 5; 6325; 3166 
1; 1053; 3162; 5; 6331; 3169 
1; 1054; 3165; 5; 6337; 3172 
1; 1055; 3168; 5; 6343; 3175 
1; 1056; 3171; 5; 6349; 3178 
1; 1057; 3174; 5; 6355; 3181 
1; 1058; 3177; 5; 6361; 3184 
1; 1059; 3180; 5; 6367; 3187 
1; 1060; 3183; 5; 6373; 3190 
1; 1061; 3186; 5; 6379; 3193 
1; 1062; 3189; 5; 6385; 3196 
1; 1063; 3192; 5; 6391; 3199 
1; 1064; 3195; 5; 6397; 3202 
1; 1065; 3198; 5; 6403; 3205 
1; 1066; 3201; 5; 6409; 3208 
1; 1067; 3204; 5; 6415; 3211 
1; 1068; 3207; 5; 6421; 3214 
1; 1069; 3210; 5; 6427; 3217 
1; 1070; 3213; 5; 6433; 3220 
1; 1071; 3216; 5; 6439; 3223 
1; 1072; 3219; 5; 6445; 3226 
1; 1073; 3222; 5; 6451; 3229 
1; 1074; 3225; 5; 6457; 3232 
1; 1075; 3228; 5; 6463; 3235 
1; 1076; 3231; 5; 6469; 3238 
1; 1077; 3234; 5; 6475; 3241 
1; 1078; 3237; 5; 6481; 3244 
1; 1079; 3240; 5; 6487; 3247 
1; 1080; 3243; 5; 6493; 3250 
1; 1081; 3246; 5; 6499; 3253 
1; 1082; 3249; 5; 6505; 3256 
1; 1083; 3252; 5; 6511; 3259 
1; 1084; 3255; 5; 6517; 3262 
1; 1085; 3258; 5; 6523; 3265 
1; 1086; 3261; 5; 6529; 3268 
1; 1087; 3264; 5; 6535; 3271 
1; 1088; 3267; 5; 6541; 3274 
1; 1089; 3270; 5; 6547; 3277 
1; 1090; 3273; 5; 6553; 3280 
1; 1091; 3276; 5; 6559; 3283 
1; 1092; 3279; 5; 6565; 3286 
1; 1093; 3282; 5; 6571; 3289 
1; 1094; 3285; 5; 6577; 3292 
1; 1095; 3288; 5; 6583; 3295 
1; 1096; 3291; 5; 6589; 3298 
1; 1097; 3294; 5; 6595; 3301 
1; 1098; 3297; 5; 6601; 3304 
1; 1099; 3300; 5; 6607; 3307 
1; 1100; 3303; 5; 6613; 3310 
1; 1101; 3306; 5; 6619; 3313 
1; 1102; 3309; 5; 6625; 3316 
1; 1103; 3312; 5; 6631; 3319 
1; 1104; 3315; 5; 6637; 3322 
1; 1105; 3318; 5; 6643; 3325 
1; 1106; 3321; 5; 6649; 3328 
1; 1107; 3324; 5; 6655; 3331 
1; 1108; 3327; 5; 6661; 3334 
1; 1109; 3330; 5; 6667; 3337 
1; 1110; 3333; 5; 6673; 3340 
1; 1111; 3336; 5; 6679; 3343 
1; 1112; 3339; 5; 6685; 3346 
1; 1113; 3342; 5; 6691; 3349 
1; 1114; 3345; 5; 6697; 3352 
1; 1115; 3348; 5; 6703; 3355 
1; 1116; 3351; 5; 6709; 3358 
1; 1117; 3354; 5; 6715; 3361 
1; 1118; 3357; 5; 6721; 3364 
1; 1119; 3360; 5; 6727; 3367 
1; 1120; 3363; 5; 6733; 3370 
1; 1121; 3366; 5; 6739; 3373 
1; 1122; 3369; 5; 6745; 3376 
1; 1123; 3372; 5; 6751; 3379 
1; 1124; 3375; 5; 6757; 3382 
1; 1125; 3378; 5; 6763; 3385 
1; 1126; 3381; 5; 6769; 3388 
1; 1127; 3384; 5; 6775; 3391 
1; 1128; 3387; 5; 6781; 3394 
1; 1129; 3390; 5; 6787; 3397 
1; 1130; 3393; 5; 6793; 3400 
1; 1131; 3396; 5; 6799; 3403 
1; 1132; 3399; 5; 6805; 3406 
1; 1133; 3402; 5; 6811; 3409 
1; 1134; 3405; 5; 6817; 3412 
1; 1135; 3408; 5; 6823; 3415 
1; 1136; 3411; 5; 6829; 3418 
1; 1137; 3414; 5; 6835; 3421 
1; 1138; 3417; 5; 6841; 3424 
1; 1139; 3420; 5; 6847; 3427 
1; 1140; 3423; 5; 6853; 3430 
1; 1141; 3426; 5; 6859; 3433 
1; 1142; 3429; 5; 6865; 3436 
1; 1143; 3432; 5; 6871; 3439 
1; 1144; 3435; 5; 6877; 3442 
1; 1145; 3438; 5; 6883; 3445 
1; 1146; 3441; 5; 6889; 3448 
1; 1147; 3444; 5; 6895; 3451 
1; 1148; 3447; 5; 6901; 3454 
1; 1149; 3450; 5; 6907; 3457 
1; 1150; 3453; 5; 6913; 3460 
1; 1151; 3456; 5; 6919; 3463 
1; 1152; 3459; 5; 6925; 3466 
1; 1153; 3462; 5; 6931; 3469 
1; 1154; 3465; 5; 6937; 3472 
1; 1155; 3468; 5; 6943; 3475 
1; 1156; 3471; 5; 6949; 3478 
1; 1157; 3474; 5; 6955; 3481 
1; 1158; 3477; 5; 6961; 3484 
1; 1159; 3480; 5; 6967; 3487 
1; 1160; 3483; 5; 6973; 3490 
1; 1161; 3486; 5; 6979; 3493 
1; 1162; 3489; 5; 6985; 3496 
1; 1163; 3492; 5; 6991; 3499 
1; 1164; 3495; 5; 6997; 3502 
1; 1165; 3498; 5; 7003; 3505 
1; 1166; 3501; 5; 7009; 3508 
1; 1167; 3504; 5; 7015; 3511 
1; 1168; 3507; 5; 7021; 3514 
1; 1169; 3510; 5; 7027; 3517 
1; 1170; 3513; 5; 7033; 3520 
1; 1171; 3516; 5; 7039; 3523 
1; 1172; 3519; 5; 7045; 3526 
1; 1173; 3522; 5; 7051; 3529 
1; 1174; 3525; 5; 7057; 3532 
1; 1175; 3528; 5; 7063; 3535 
1; 1176; 3531; 5; 7069; 3538 
1; 1177; 3534; 5; 7075; 3541 
1; 1178; 3537; 5; 7081; 3544 
1; 1179; 3540; 5; 7087; 3547 
1; 1180; 3543; 5; 7093; 3550 
1; 1181; 3546; 5; 7099; 3553 
1; 1182; 3549; 5; 7105; 3556 
1; 1183; 3552; 5; 7111; 3559 
1; 1184; 3555; 5; 7117; 3562 
1; 1185; 3558; 5; 7123; 3565 
1; 1186; 3561; 5; 7129; 3568 
1; 1187; 3564; 5; 7135; 3571 
1; 1188; 3567; 5; 7141; 3574 
1; 1189; 3570; 5; 7147; 3577 
1; 1190; 3573; 5; 7153; 3580 
1; 1191; 3576; 5; 7159; 3583 
1; 1192; 3579; 5; 7165; 3586 
1; 1193; 3582; 5; 7171; 3589 
1; 1194; 3585; 5; 7177; 3592 
1; 1195; 3588; 5; 7183; 3595 
1; 1196; 3591; 5; 7189; 3598 
1; 1197; 3594; 5; 7195; 3601 
1; 1198; 3597; 5; 7201; 3604 
1; 1199; 3600; 5; 7207; 3607 
1; 1200; 3603; 5; 7213; 3610 
1; 1201; 3606; 5; 7219; 3613 
1; 1202; 3609; 5; 7225; 3616 
1; 1203; 3612; 5; 7231; 3619 
1; 1204; 3615; 5; 7237; 3622 
1; 1205; 3618; 5; 7243; 3625 
1; 1206; 3621; 5; 7249; 3628 
1; 1207; 3624; 5; 7255; 3631 
1; 1208; 3627; 5; 7261; 3634 
1; 1209; 3630; 5; 7267; 3637 
1; 1210; 3633; 5; 7273; 3640 
1; 1211; 3636; 5; 7279; 3643 
1; 1212; 3639; 5; 7285; 3646 
1; 1213; 3642; 5; 7291; 3649 
1; 1214; 3645; 5; 7297; 3652 
1; 1215; 3648; 5; 7303; 3655 
1; 1216; 3651; 5; 7309; 3658 
1; 1217; 3654; 5; 7315; 3661 
1; 1218; 3657; 5; 7321; 3664 
1; 1219; 3660; 5; 7327; 3667 
1; 1220; 3663; 5; 7333; 3670 
1; 1221; 3666; 5; 7339; 3673 
1; 1222; 3669; 5; 7345; 3676 
1; 1223; 3672; 5; 7351; 3679 
1; 1224; 3675; 5; 7357; 3682 
1; 1225; 3678; 5; 7363; 3685 
1; 1226; 3681; 5; 7369; 3688 
1; 1227; 3684; 5; 7375; 3691 
1; 1228; 3687; 5; 7381; 3694 
1; 1229; 3690; 5; 7387; 3697 
1; 1230; 3693; 5; 7393; 3700 
1; 1231; 3696; 5; 7399; 3703 
1; 1232; 3699; 5; 7405; 3706 
1; 1233; 3702; 5; 7411; 3709 
1; 1234; 3705; 5; 7417; 3712 
1; 1235; 3708; 5; 7423; 3715 
1; 1236; 3711; 5; 7429; 3718 
1; 1237; 3714; 5; 7435; 3721 
1; 1238; 3717; 5; 7441; 3724 
1; 1239; 3720; 5; 7447; 3727 
1; 1240; 3723; 5; 7453; 3730 
1; 1241; 3726; 5; 7459; 3733 
1; 1242; 3729; 5; 7465; 3736 
1; 1243; 3732; 5; 7471; 3739 
1; 1244; 3735; 5; 7477; 3742 
1; 1245; 3738; 5; 7483; 3745 
1; 1246; 3741; 5; 7489; 3748 
1; 1247; 3744; 5; 7495; 3751 
1; 1248; 3747; 5; 7501; 3754 
1; 1249; 3750; 5; 7507; 3757 
1; 1250; 3753; 5; 7513; 3760 
1; 1251; 3756; 5; 7519; 3763 
1; 1252; 3759; 5; 7525; 3766 
1; 1253; 3762; 5; 7531; 3769 
1; 1254; 3765; 5; 7537; 3772 
1; 1255; 3768; 5; 7543; 3775 
1; 1256; 3771; 5; 7549; 3778 
1; 1257; 3774; 5; 7555; 3781 
1; 1258; 3777; 5; 7561; 3784 
1; 1259; 3780; 5; 7567; 3787 
1; 1260; 3783; 5; 7573; 3790 
1; 1261; 3786; 5; 7579; 3793 
1; 1262; 3789; 5; 7585; 3796 
1; 1263; 3792; 5; 7591; 3799 
1; 1264; 3795; 5; 7597; 3802 
1; 1265; 3798; 5; 7603; 3805 
1; 1266; 3801; 5; 7609; 3808 
1; 1267; 3804; 5; 7615; 3811 
1; 1268; 3807; 5; 7621; 3814 
1; 1269; 3810; 5; 7627; 3817 
1; 1270; 3813; 5; 7633; 3820 
1; 1271; 3816; 5; 7639; 3823 
1; 1272; 3819; 5; 7645; 3826 
1; 1273; 3822; 5; 7651; 3829 
1; 1274; 3825; 5; 7657; 3832 
1; 1275; 3828; 5; 7663; 3835 
1; 1276; 3831; 5; 7669; 3838 
1; 1277; 3834; 5; 7675; 3841 
1; 1278; 3837; 5; 7681; 3844 
1; 1279; 3840; 5; 7687; 3847 
1; 1280; 3843; 5; 7693; 3850 
1; 1281; 3846; 5; 7699; 3853 
1; 1282; 3849; 5; 7705; 3856 
1; 1283; 3852; 5; 7711; 3859 
1; 1284; 3855; 5; 7717; 3862 
1; 1285; 3858; 5; 7723; 3865 
1; 1286; 3861; 5; 7729; 3868 
1; 1287; 3864; 5; 7735; 3871 
1; 1288; 3867; 5; 7741; 3874 
1; 1289; 3870; 5; 7747; 3877 
1; 1290; 3873; 5; 7753; 3880 
1; 1291; 3876; 5; 7759; 3883 
1; 1292; 3879; 5; 7765; 3886 
1; 1293; 3882; 5; 7771; 3889 
1; 1294; 3885; 5; 7777; 3892 
1; 1295; 3888; 5; 7783; 3895 
1; 1296; 3891; 5; 7789; 3898 
1; 1297; 3894; 5; 7795; 3901 
1; 1298; 3897; 5; 7801; 3904 
1; 1299; 3900; 5; 7807; 3907 
1; 1300; 3903; 5; 7813; 3910 
1; 1301; 3906; 5; 7819; 3913 
1; 1302; 3909; 5; 7825; 3916 
1; 1303; 3912; 5; 7831; 3919 
1; 1304; 3915; 5; 7837; 3922 
1; 1305; 3918; 5; 7843; 3925 
1; 1306; 3921; 5; 7849; 3928 
1; 1307; 3924; 5; 7855; 3931 
1; 1308; 3927; 5; 7861; 3934 
1; 1309; 3930; 5; 7867; 3937 
1; 1310; 3933; 5; 7873; 3940 
1; 1311; 3936; 5; 7879; 3943 
1; 1312; 3939; 5; 7885; 3946 
1; 1313; 3942; 5; 7891; 3949 
1; 1314; 3945; 5; 7897; 3952 
1; 1315; 3948; 5; 7903; 3955 
1; 1316; 3951; 5; 7909; 3958 
1; 1317; 3954; 5; 7915; 3961 
1; 1318; 3957; 5; 7921; 3964 
1; 1319; 3960; 5; 7927; 3967 
1; 1320; 3963; 5; 7933; 3970 
1; 1321; 3966; 5; 7939; 3973 
1; 1322; 3969; 5; 7945; 3976 
1; 1323; 3972; 5; 7951; 3979 
1; 1324; 3975; 5; 7957; 3982 
1; 1325; 3978; 5; 7963; 3985 
1; 1326; 3981; 5; 7969; 3988 
1; 1327; 3984; 5; 7975; 3991 
1; 1328; 3987; 5; 7981; 3994 
1; 1329; 3990; 5; 7987; 3997 
1; 1330; 3993; 5; 7993; 4000 
1; 1331; 3996; 5; 7999; 4003 
1; 1332; 3999; 5; 8005; 4006 
1; 1333; 4002; 5; 8011; 4009 
1; 1334; 4005; 5; 8017; 4012 
1; 1335; 4008; 5; 8023; 4015 
1; 1336; 4011; 5; 8029; 4018 
1; 1337; 4014; 5; 8035; 4021 
1; 1338; 4017; 5; 8041; 4024 
1; 1339; 4020; 5; 8047; 4027 
1; 1340; 4023; 5; 8053; 4030 
1; 1341; 4026; 5; 8059; 4033 
1; 1342; 4029; 5; 8065; 4036 
1; 1343; 4032; 5; 8071; 4039 
1; 1344; 4035; 5; 8077; 4042 
1; 1345; 4038; 5; 8083; 4045 
1; 1346; 4041; 5; 8089; 4048 
1; 1347; 4044; 5; 8095; 4051 
1; 1348; 4047; 5; 8101; 4054 
1; 1349; 4050; 5; 8107; 4057 
1; 1350; 4053; 5; 8113; 4060 
1; 1351; 4056; 5; 8119; 4063 
1; 1352; 4059; 5; 8125; 4066 
1; 1353; 4062; 5; 8131; 4069 
1; 1354; 4065; 5; 8137; 4072 
1; 1355; 4068; 5; 8143; 4075 
1; 1356; 4071; 5; 8149; 4078 
1; 1357; 4074; 5; 8155; 4081 
1; 1358; 4077; 5; 8161; 4084 
1; 1359; 4080; 5; 8167; 4087 
1; 1360; 4083; 5; 8173; 4090 
1; 1361; 4086; 5; 8179; 4093 
1; 1362; 4089; 5; 8185; 4096 
1; 1363; 4092; 5; 8191; 4099 
1; 1364; 4095; 5; 8197; 4102 
1; 1365; 4098; 5; 8203; 4105 
1; 1366; 4101; 5; 8209; 4108 
1; 1367; 4104; 5; 8215; 4111 
1; 1368; 4107; 5; 8221; 4114 
1; 1369; 4110; 5; 8227; 4117 
1; 1370; 4113; 5; 8233; 4120 
1; 1371; 4116; 5; 8239; 4123 
1; 1372; 4119; 5; 8245; 4126 
1; 1373; 4122; 5; 8251; 4129 
1; 1374; 4125; 5; 8257; 4132 
1; 1375; 4128; 5; 8263; 4135 
1; 1376; 4131; 5; 8269; 4138 
1; 1377; 4134; 5; 8275; 4141 
1; 1378; 4137; 5; 8281; 4144 
1; 1379; 4140; 5; 8287; 4147 
1; 1380; 4143; 5; 8293; 4150 
1; 1381; 4146; 5; 8299; 4153 
1; 1382; 4149; 5; 8305; 4156 
1; 1383; 4152; 5; 8311; 4159 
1; 1384; 4155; 5; 8317; 4162 
1; 1385; 4158; 5; 8323; 4165 
1; 1386; 4161; 5; 8329; 4168 
1; 1387; 4164; 5; 8335; 4171 
1; 1388; 4167; 5; 8341; 4174 
1; 1389; 4170; 5; 8347; 4177 
1; 1390; 4173; 5; 8353; 4180 
1; 1391; 4176; 5; 8359; 4183 
1; 1392; 4179; 5; 8365; 4186 
1; 1393; 4182; 5; 8371; 4189 
1; 1394; 4185; 5; 8377; 4192 
1; 1395; 4188; 5; 8383; 4195 
1; 1396; 4191; 5; 8389; 4198 
1; 1397; 4194; 5; 8395; 4201 
1; 1398; 4197; 5; 8401; 4204 
1; 1399; 4200; 5; 8407; 4207 
1; 1400; 4203; 5; 8413; 4210 
1; 1401; 4206; 5; 8419; 4213 
1; 1402; 4209; 5; 8425; 4216 
1; 1403; 4212; 5; 8431; 4219 
1; 1404; 4215; 5; 8437; 4222 
1; 1405; 4218; 5; 8443; 4225 
1; 1406; 4221; 5; 8449; 4228 
1; 1407; 4224; 5; 8455; 4231 
1; 1408; 4227; 5; 8461; 4234 
1; 1409; 4230; 5; 8467; 4237 
1; 1410; 4233; 5; 8473; 4240 
1; 1411; 4236; 5; 8479; 4243 
1; 1412; 4239; 5; 8485; 4246 
1; 1413; 4242; 5; 8491; 4249 
1; 1414; 4245; 5; 8497; 4252 
1; 1415; 4248; 5; 8503; 4255 
1; 1416; 4251; 5; 8509; 4258 
1; 1417; 4254; 5; 8515; 4261 
1; 1418; 4257; 5; 8521; 4264 
1; 1419; 4260; 5; 8527; 4267 
1; 1420; 4263; 5; 8533; 4270 
1; 1421; 4266; 5; 8539; 4273 
1; 1422; 4269; 5; 8545; 4276 
1; 1423; 4272; 5; 8551; 4279 
1; 1424; 4275; 5; 8557; 4282 
1; 1425; 4278; 5; 8563; 4285 
1; 1426; 4281; 5; 8569; 4288 
1; 1427; 4284; 5; 8575; 4291 
1; 1428; 4287; 5; 8581; 4294 
1; 1429; 4290; 5; 8587; 4297 
1; 1430; 4293; 5; 8593; 4300 
1; 1431; 4296; 5; 8599; 4303 
1; 1432; 4299; 5; 8605; 4306 
1; 1433; 4302; 5; 8611; 4309 
1; 1434; 4305; 5; 8617; 4312 
1; 1435; 4308; 5; 8623; 4315 
1; 1436; 4311; 5; 8629; 4318 
1; 1437; 4314; 5; 8635; 4321 
1; 1438; 4317; 5; 8641; 4324 
1; 1439; 4320; 5; 8647; 4327 
1; 1440; 4323; 5; 8653; 4330 
1; 1441; 4326; 5; 8659; 4333 
1; 1442; 4329; 5; 8665; 4336 
1; 1443; 4332; 5; 8671; 4339 
1; 1444; 4335; 5; 8677; 4342 
1; 1445; 4338; 5; 8683; 4345 
1; 1446; 4341; 5; 8689; 4348 
1; 1447; 4344; 5; 8695; 4351 
1; 1448; 4347; 5; 8701; 4354 
1; 1449; 4350; 5; 8707; 4357 
1; 1450; 4353; 5; 8713; 4360 
1; 1451; 4356; 5; 8719; 4363 
1; 1452; 4359; 5; 8725; 4366 
1; 1453; 4362; 5; 8731; 4369 
1; 1454; 4365; 5; 8737; 4372 
1; 1455; 4368; 5; 8743; 4375 
1; 1456; 4371; 5; 8749; 4378 
1; 1457; 4374; 5; 8755; 4381 
1; 1458; 4377; 5; 8761; 4384 
1; 1459; 4380; 5; 8767; 4387 
1; 1460; 4383; 5; 8773; 4390 
1; 1461; 4386; 5; 8779; 4393 
1; 1462; 4389; 5; 8785; 4396 
1; 1463; 4392; 5; 8791; 4399 
1; 1464; 4395; 5; 8797; 4402 
1; 1465; 4398; 5; 8803; 4405 
1; 1466; 4401; 5; 8809; 4408 
1; 1467; 4404; 5; 8815; 4411 
1; 1468; 4407; 5; 8821; 4414 
1; 1469; 4410; 5; 8827; 4417 
1; 1470; 4413; 5; 8833; 4420 
1; 1471; 4416; 5; 8839; 4423 
1; 1472; 4419; 5; 8845; 4426 
1; 1473; 4422; 5; 8851; 4429 
1; 1474; 4425; 5; 8857; 4432 
1; 1475; 4428; 5; 8863; 4435 
1; 1476; 4431; 5; 8869; 4438 
1; 1477; 4434; 5; 8875; 4441 
1; 1478; 4437; 5; 8881; 4444 
1; 1479; 4440; 5; 8887; 4447 
1; 1480; 4443; 5; 8893; 4450 
1; 1481; 4446; 5; 8899; 4453 
1; 1482; 4449; 5; 8905; 4456 
1; 1483; 4452; 5; 8911; 4459 
1; 1484; 4455; 5; 8917; 4462 
1; 1485; 4458; 5; 8923; 4465 
1; 1486; 4461; 5; 8929; 4468 
1; 1487; 4464; 5; 8935; 4471 
1; 1488; 4467; 5; 8941; 4474 
1; 1489; 4470; 5; 8947; 4477 
1; 1490; 4473; 5; 8953; 4480 
1; 1491; 4476; 5; 8959; 4483 
1; 1492; 4479; 5; 8965; 4486 
1; 1493; 4482; 5; 8971; 4489 
1; 1494; 4485; 5; 8977; 4492 
1; 1495; 4488; 5; 8983; 4495 
1; 1496; 4491; 5; 8989; 4498 
1; 1497; 4494; 5; 8995; 4501 
1; 1498; 4497; 5; 9001; 4504 
1; 1499; 4500; 5; 9007; 4507 
1; 1500; 4503; 5; 9013; 4510 
1; 1501; 4506; 5; 9019; 4513 
1; 1502; 4509; 5; 9025; 4516 
1; 1503; 4512; 5; 9031; 4519 
1; 1504; 4515; 5; 9037; 4522 
1; 1505; 4518; 5; 9043; 4525 
1; 1506; 4521; 5; 9049; 4528 
1; 1507; 4524; 5; 9055; 4531 
1; 1508; 4527; 5; 9061; 4534 
1; 1509; 4530; 5; 9067; 4537 
1; 1510; 4533; 5; 9073; 4540 
1; 1511; 4536; 5; 9079; 4543 
1; 1512; 4539; 5; 9085; 4546 
1; 1513; 4542; 5; 9091; 4549 
1; 1514; 4545; 5; 9097; 4552 
1; 1515; 4548; 5; 9103; 4555 
1; 1516; 4551; 5; 9109; 4558 
1; 1517; 4554; 5; 9115; 4561 
1; 1518; 4557; 5; 9121; 4564 
1; 1519; 4560; 5; 9127; 4567 
1; 1520; 4563; 5; 9133; 4570 
1; 1521; 4566; 5; 9139; 4573 
1; 1522; 4569; 5; 9145; 4576 
1; 1523; 4572; 5; 9151; 4579 
1; 1524; 4575; 5; 9157; 4582 
1; 1525; 4578; 5; 9163; 4585 
1; 1526; 4581; 5; 9169; 4588 
1; 1527; 4584; 5; 9175; 4591 
1; 1528; 4587; 5; 9181; 4594 
1; 1529; 4590; 5; 9187; 4597 
1; 1530; 4593; 5; 9193; 4600 
1; 1531; 4596; 5; 9199; 4603 
1; 1532; 4599; 5; 9205; 4606 
1; 1533; 4602; 5; 9211; 4609 
1; 1534; 4605; 5; 9217; 4612 
1; 1535; 4608; 5; 9223; 4615 
1; 1536; 4611; 5; 9229; 4618 
1; 1537; 4614; 5; 9235; 4621 
1; 1538; 4617; 5; 9241; 4624 
1; 1539; 4620; 5; 9247; 4627 
1; 1540; 4623; 5; 9253; 4630 
1; 1541; 4626; 5; 9259; 4633 
1; 1542; 4629; 5; 9265; 4636 
1; 1543; 4632; 5; 9271; 4639 
1; 1544; 4635; 5; 9277; 4642 
1; 1545; 4638; 5; 9283; 4645 
1; 1546; 4641; 5; 9289; 4648 
1; 1547; 4644; 5; 9295; 4651 
1; 1548; 4647; 5; 9301; 4654 
1; 1549; 4650; 5; 9307; 4657 
1; 1550; 4653; 5; 9313; 4660 
1; 1551; 4656; 5; 9319; 4663 
1; 1552; 4659; 5; 9325; 4666 
1; 1553; 4662; 5; 9331; 4669 
1; 1554; 4665; 5; 9337; 4672 
1; 1555; 4668; 5; 9343; 4675 
1; 1556; 4671; 5; 9349; 4678 
1; 1557; 4674; 5; 9355; 4681 
1; 1558; 4677; 5; 9361; 4684 
1; 1559; 4680; 5; 9367; 4687 
1; 1560; 4683; 5; 9373; 4690 
1; 1561; 4686; 5; 9379; 4693 
1; 1562; 4689; 5; 9385; 4696 
1; 1563; 4692; 5; 9391; 4699 
1; 1564; 4695; 5; 9397; 4702 
1; 1565; 4698; 5; 9403; 4705 
1; 1566; 4701; 5; 9409; 4708 
1; 1567; 4704; 5; 9415; 4711 
1; 1568; 4707; 5; 9421; 4714 
1; 1569; 4710; 5; 9427; 4717 
1; 1570; 4713; 5; 9433; 4720 
1; 1571; 4716; 5; 9439; 4723 
1; 1572; 4719; 5; 9445; 4726 
1; 1573; 4722; 5; 9451; 4729 
1; 1574; 4725; 5; 9457; 4732 
1; 1575; 4728; 5; 9463; 4735 
1; 1576; 4731; 5; 9469; 4738 
1; 1577; 4734; 5; 9475; 4741 
1; 1578; 4737; 5; 9481; 4744 
1; 1579; 4740; 5; 9487; 4747 
1; 1580; 4743; 5; 9493; 4750 
1; 1581; 4746; 5; 9499; 4753 
1; 1582; 4749; 5; 9505; 4756 
1; 1583; 4752; 5; 9511; 4759 
1; 1584; 4755; 5; 9517; 4762 
1; 1585; 4758; 5; 9523; 4765 
1; 1586; 4761; 5; 9529; 4768 
1; 1587; 4764; 5; 9535; 4771 
1; 1588; 4767; 5; 9541; 4774 
1; 1589; 4770; 5; 9547; 4777 
1; 1590; 4773; 5; 9553; 4780 
1; 1591; 4776; 5; 9559; 4783 
1; 1592; 4779; 5; 9565; 4786 
1; 1593; 4782; 5; 9571; 4789 
1; 1594; 4785; 5; 9577; 4792 
1; 1595; 4788; 5; 9583; 4795 
1; 1596; 4791; 5; 9589; 4798 
1; 1597; 4794; 5; 9595; 4801 
1; 1598; 4797; 5; 9601; 4804 
1; 1599; 4800; 5; 9607; 4807 
1; 1600; 4803; 5; 9613; 4810 
1; 1601; 4806; 5; 9619; 4813 
1; 1602; 4809; 5; 9625; 4816 
1; 1603; 4812; 5; 9631; 4819 
1; 1604; 4815; 5; 9637; 4822 
1; 1605; 4818; 5; 9643; 4825 
1; 1606; 4821; 5; 9649; 4828 
1; 1607; 4824; 5; 9655; 4831 
1; 1608; 4827; 5; 9661; 4834 
1; 1609; 4830; 5; 9667; 4837 
1; 1610; 4833; 5; 9673; 4840 
1; 1611; 4836; 5; 9679; 4843 
1; 1612; 4839; 5; 9685; 4846 
1; 1613; 4842; 5; 9691; 4849 
1; 1614; 4845; 5; 9697; 4852 
1; 1615; 4848; 5; 9703; 4855 
1; 1616; 4851; 5; 9709; 4858 
1; 1617; 4854; 5; 9715; 4861 
1; 1618; 4857; 5; 9721; 4864 
1; 1619; 4860; 5; 9727; 4867 
1; 1620; 4863; 5; 9733; 4870 
1; 1621; 4866; 5; 9739; 4873 
1; 1622; 4869; 5; 9745; 4876 
1; 1623; 4872; 5; 9751; 4879 
1; 1624; 4875; 5; 9757; 4882 
1; 1625; 4878; 5; 9763; 4885 
1; 1626; 4881; 5; 9769; 4888 
1; 1627; 4884; 5; 9775; 4891 
1; 1628; 4887; 5; 9781; 4894 
1; 1629; 4890; 5; 9787; 4897 
1; 1630; 4893; 5; 9793; 4900 
1; 1631; 4896; 5; 9799; 4903 
1; 1632; 4899; 5; 9805; 4906 
1; 1633; 4902; 5; 9811; 4909 
1; 1634; 4905; 5; 9817; 4912 
1; 1635; 4908; 5; 9823; 4915 
1; 1636; 4911; 5; 9829; 4918 
1; 1637; 4914; 5; 9835; 4921 
1; 1638; 4917; 5; 9841; 4924 
1; 1639; 4920; 5; 9847; 4927 
1; 1640; 4923; 5; 9853; 4930 
1; 1641; 4926; 5; 9859; 4933 
1; 1642; 4929; 5; 9865; 4936 
1; 1643; 4932; 5; 9871; 4939 
1; 1644; 4935; 5; 9877; 4942 
1; 1645; 4938; 5; 9883; 4945 
1; 1646; 4941; 5; 9889; 4948 
1; 1647; 4944; 5; 9895; 4951 
1; 1648; 4947; 5; 9901; 4954 
1; 1649; 4950; 5; 9907; 4957 
1; 1650; 4953; 5; 9913; 4960 
1; 1651; 4956; 5; 9919; 4963 
1; 1652; 4959; 5; 9925; 4966 
1; 1653; 4962; 5; 9931; 4969 
1; 1654; 4965; 5; 9937; 4972 
1; 1655; 4968; 5; 9943; 4975 
1; 1656; 4971; 5; 9949; 4978 
1; 1657; 4974; 5; 9955; 4981 
1; 1658; 4977; 5; 9961; 4984 
1; 1659; 4980; 5; 9967; 4987 
1; 1660; 4983; 5; 9973; 4990 
1; 1661; 4986; 5; 9979; 4993 
1; 1662; 4989; 5; 9985; 4996 
1; 1663; 4992; 5; 9991; 4999 
1; 1664; 4995; 5; 9997; 5002 
1; 1665; 4998; 5; 10003; 5005 
1; 1666; 5001; 5; 10009; 5008 
1; 1667; 5004; 5; 10015; 5011 
1; 1668; 5007; 5; 10021; 5014 
1; 1669; 5010; 5; 10027; 5017 
1; 1670; 5013; 5; 10033; 5020 
1; 1671; 5016; 5; 10039; 5023 
1; 1672; 5019; 5; 10045; 5026 
1; 1673; 5022; 5; 10051; 5029 
1; 1674; 5025; 5; 10057; 5032 
1; 1675; 5028; 5; 10063; 5035 
1; 1676; 5031; 5; 10069; 5038 
1; 1677; 5034; 5; 10075; 5041 
1; 1678; 5037; 5; 10081; 5044 
1; 1679; 5040; 5; 10087; 5047 
1; 1680; 5043; 5; 10093; 5050 
1; 1681; 5046; 5; 10099; 5053 
1; 1682; 5049; 5; 10105; 5056 
1; 1683; 5052; 5; 10111; 5059 
1; 1684; 5055; 5; 10117; 5062 
1; 1685; 5058; 5; 10123; 5065 
1; 1686; 5061; 5; 10129; 5068 
1; 1687; 5064; 5; 10135; 5071 
1; 1688; 5067; 5; 10141; 5074 
1; 1689; 5070; 5; 10147; 5077 
1; 1690; 5073; 5; 10153; 5080 
1; 1691; 5076; 5; 10159; 5083 
1; 1692; 5079; 5; 10165; 5086 
1; 1693; 5082; 5; 10171; 5089 
1; 1694; 5085; 5; 10177; 5092 
1; 1695; 5088; 5; 10183; 5095 
1; 1696; 5091; 5; 10189; 5098 
1; 1697; 5094; 5; 10195; 5101 
1; 1698; 5097; 5; 10201; 5104 
1; 1699; 5100; 5; 10207; 5107 
1; 1700; 5103; 5; 10213; 5110 
1; 1701; 5106; 5; 10219; 5113 
1; 1702; 5109; 5; 10225; 5116 
1; 1703; 5112; 5; 10231; 5119 
1; 1704; 5115; 5; 10237; 5122 
1; 1705; 5118; 5; 10243; 5125 
1; 1706; 5121; 5; 10249; 5128 
1; 1707; 5124; 5; 10255; 5131 
1; 1708; 5127; 5; 10261; 5134 
1; 1709; 5130; 5; 10267; 5137 
1; 1710; 5133; 5; 10273; 5140 
1; 1711; 5136; 5; 10279; 5143 
1; 1712; 5139; 5; 10285; 5146 
1; 1713; 5142; 5; 10291; 5149 
1; 1714; 5145; 5; 10297; 5152 
1; 1715; 5148; 5; 10303; 5155 
1; 1716; 5151; 5; 10309; 5158 
1; 1717; 5154; 5; 10315; 5161 
1; 1718; 5157; 5; 10321; 5164 
1; 1719; 5160; 5; 10327; 5167 
1; 1720; 5163; 5; 10333; 5170 
1; 1721; 5166; 5; 10339; 5173 
1; 1722; 5169; 5; 10345; 5176 
1; 1723; 5172; 5; 10351; 5179 
1; 1724; 5175; 5; 10357; 5182 
1; 1725; 5178; 5; 10363; 5185 
1; 1726; 5181; 5; 10369; 5188 
1; 1727; 5184; 5; 10375; 5191 
1; 1728; 5187; 5; 10381; 5194 
1; 1729; 5190; 5; 10387; 5197 
1; 1730; 5193; 5; 10393; 5200 
1; 1731; 5196; 5; 10399; 5203 
1; 1732; 5199; 5; 10405; 5206 
1; 1733; 5202; 5; 10411; 5209 
1; 1734; 5205; 5; 10417; 5212 
1; 1735; 5208; 5; 10423; 5215 
1; 1736; 5211; 5; 10429; 5218 
1; 1737; 5214; 5; 10435; 5221 
1; 1738; 5217; 5; 10441; 5224 
1; 1739; 5220; 5; 10447; 5227 
1; 1740; 5223; 5; 10453; 5230 
1; 1741; 5226; 5; 10459; 5233 
1; 1742; 5229; 5; 10465; 5236 
1; 1743; 5232; 5; 10471; 5239 
1; 1744; 5235; 5; 10477; 5242 
1; 1745; 5238; 5; 10483; 5245 
1; 1746; 5241; 5; 10489; 5248 
1; 1747; 5244; 5; 10495; 5251 
1; 1748; 5247; 5; 10501; 5254 
1; 1749; 5250; 5; 10507; 5257 
1; 1750; 5253; 5; 10513; 5260 
1; 1751; 5256; 5; 10519; 5263 
1; 1752; 5259; 5; 10525; 5266 
1; 1753; 5262; 5; 10531; 5269 
1; 1754; 5265; 5; 10537; 5272 
1; 1755; 5268; 5; 10543; 5275 
1; 1756; 5271; 5; 10549; 5278 
1; 1757; 5274; 5; 10555; 5281 
1; 1758; 5277; 5; 10561; 5284 
1; 1759; 5280; 5; 10567; 5287 
1; 1760; 5283; 5; 10573; 5290 
1; 1761; 5286; 5; 10579; 5293 
1; 1762; 5289; 5; 10585; 5296 
1; 1763; 5292; 5; 10591; 5299 
1; 1764; 5295; 5; 10597; 5302 
1; 1765; 5298; 5; 10603; 5305 
1; 1766; 5301; 5; 10609; 5308 
1; 1767; 5304; 5; 10615; 5311 
1; 1768; 5307; 5; 10621; 5314 
1; 1769; 5310; 5; 10627; 5317 
1; 1770; 5313; 5; 10633; 5320 
1; 1771; 5316; 5; 10639; 5323 
1; 1772; 5319; 5; 10645; 5326 
1; 1773; 5322; 5; 10651; 5329 
1; 1774; 5325; 5; 10657; 5332 
1; 1775; 5328; 5; 10663; 5335 
1; 1776; 5331; 5; 10669; 5338 
1; 1777; 5334; 5; 10675; 5341 
1; 1778; 5337; 5; 10681; 5344 
1; 1779; 5340; 5; 10687; 5347 
1; 1780; 5343; 5; 10693; 5350 
1; 1781; 5346; 5; 10699; 5353 
1; 1782; 5349; 5; 10705; 5356 
1; 1783; 5352; 5; 10711; 5359 
1; 1784; 5355; 5; 10717; 5362 
1; 1785; 5358; 5; 10723; 5365 
1; 1786; 5361; 5; 10729; 5368 
1; 1787; 5364; 5; 10735; 5371 
1; 1788; 5367; 5; 10741; 5374 
1; 1789; 5370; 5; 10747; 5377 
1; 1790; 5373; 5; 10753; 5380 
1; 1791; 5376; 5; 10759; 5383 
1; 1792; 5379; 5; 10765; 5386 
1; 1793; 5382; 5; 10771; 5389 
1; 1794; 5385; 5; 10777; 5392 
1; 1795; 5388; 5; 10783; 5395 
1; 1796; 5391; 5; 10789; 5398 
1; 1797; 5394; 5; 10795; 5401 
1; 1798; 5397; 5; 10801; 5404 
1; 1799; 5400; 5; 10807; 5407 
1; 1800; 5403; 5; 10813; 5410 
1; 1801; 5406; 5; 10819; 5413 
1; 1802; 5409; 5; 10825; 5416 
1; 1803; 5412; 5; 10831; 5419 
1; 1804; 5415; 5; 10837; 5422 
1; 1805; 5418; 5; 10843; 5425 
1; 1806; 5421; 5; 10849; 5428 
1; 1807; 5424; 5; 10855; 5431 
1; 1808; 5427; 5; 10861; 5434 
1; 1809; 5430; 5; 10867; 5437 
1; 1810; 5433; 5; 10873; 5440 
1; 1811; 5436; 5; 10879; 5443 
1; 1812; 5439; 5; 10885; 5446 
1; 1813; 5442; 5; 10891; 5449 
1; 1814; 5445; 5; 10897; 5452 
1; 1815; 5448; 5; 10903; 5455 
1; 1816; 5451; 5; 10909; 5458 
1; 1817; 5454; 5; 10915; 5461 
1; 1818; 5457; 5; 10921; 5464 
1; 1819; 5460; 5; 10927; 5467 
1; 1820; 5463; 5; 10933; 5470 
1; 1821; 5466; 5; 10939; 5473 
1; 1822; 5469; 5; 10945; 5476 
1; 1823; 5472; 5; 10951; 5479 
1; 1824; 5475; 5; 10957; 5482 
1; 1825; 5478; 5; 10963; 5485 
1; 1826; 5481; 5; 10969; 5488 
1; 1827; 5484; 5; 10975; 5491 
1; 1828; 5487; 5; 10981; 5494 
1; 1829; 5490; 5; 10987; 5497 
1; 1830; 5493; 5; 10993; 5500 
1; 1831; 5496; 5; 10999; 5503 
1; 1832; 5499; 5; 11005; 5506 
1; 1833; 5502; 5; 11011; 5509 
1; 1834; 5505; 5; 11017; 5512 
1; 1835; 5508; 5; 11023; 5515 
1; 1836; 5511; 5; 11029; 5518 
1; 1837; 5514; 5; 11035; 5521 
1; 1838; 5517; 5; 11041; 5524 
1; 1839; 5520; 5; 11047; 5527 
1; 1840; 5523; 5; 11053; 5530 
1; 1841; 5526; 5; 11059; 5533 
1; 1842; 5529; 5; 11065; 5536 
1; 1843; 5532; 5; 11071; 5539 
1; 1844; 5535; 5; 11077; 5542 
1; 1845; 5538; 5; 11083; 5545 
1; 1846; 5541; 5; 11089; 5548 
1; 1847; 5544; 5; 11095; 5551 
1; 1848; 5547; 5; 11101; 5554 
1; 1849; 5550; 5; 11107; 5557 
1; 1850; 5553; 5; 11113; 5560 
1; 1851; 5556; 5; 11119; 5563 
1; 1852; 5559; 5; 11125; 5566 
1; 1853; 5562; 5; 11131; 5569 
1; 1854; 5565; 5; 11137; 5572 
1; 1855; 5568; 5; 11143; 5575 
1; 1856; 5571; 5; 11149; 5578 
1; 1857; 5574; 5; 11155; 5581 
1; 1858; 5577; 5; 11161; 5584 
1; 1859; 5580; 5; 11167; 5587 
1; 1860; 5583; 5; 11173; 5590 
1; 1861; 5586; 5; 11179; 5593 
1; 1862; 5589; 5; 11185; 5596 
1; 1863; 5592; 5; 11191; 5599 
1; 1864; 5595; 5; 11197; 5602 
1; 1865; 5598; 5; 11203; 5605 
1; 1866; 5601; 5; 11209; 5608 
1; 1867; 5604; 5; 11215; 5611 
1; 1868; 5607; 5; 11221; 5614 
1; 1869; 5610; 5; 11227; 5617 
1; 1870; 5613; 5; 11233; 5620 
1; 1871; 5616; 5; 11239; 5623 
1; 1872; 5619; 5; 11245; 5626 
1; 1873; 5622; 5; 11251; 5629 
1; 1874; 5625; 5; 11257; 5632 
1; 1875; 5628; 5; 11263; 5635 
1; 1876; 5631; 5; 11269; 5638 
1; 1877; 5634; 5; 11275; 5641 
1; 1878; 5637; 5; 11281; 5644 
1; 1879; 5640; 5; 11287; 5647 
1; 1880; 5643; 5; 11293; 5650 
1; 1881; 5646; 5; 11299; 5653 
1; 1882; 5649; 5; 11305; 5656 
1; 1883; 5652; 5; 11311; 5659 
1; 1884; 5655; 5; 11317; 5662 
1; 1885; 5658; 5; 11323; 5665 
1; 1886; 5661; 5; 11329; 5668 
1; 1887; 5664; 5; 11335; 5671 
1; 1888; 5667; 5; 11341; 5674 
1; 1889; 5670; 5; 11347; 5677 
1; 1890; 5673; 5; 11353; 5680 
1; 1891; 5676; 5; 11359; 5683 
1; 1892; 5679; 5; 11365; 5686 
1; 1893; 5682; 5; 11371; 5689 
1; 1894; 5685; 5; 11377; 5692 
1; 1895; 5688; 5; 11383; 5695 
1; 1896; 5691; 5; 11389; 5698 
1; 1897; 5694; 5; 11395; 5701 
1; 1898; 5697; 5; 11401; 5704 
1; 1899; 5700; 5; 11407; 5707 
1; 1900; 5703; 5; 11413; 5710 
1; 1901; 5706; 5; 11419; 5713 
1; 1902; 5709; 5; 11425; 5716 
1; 1903; 5712; 5; 11431; 5719 
1; 1904; 5715; 5; 11437; 5722 
1; 1905; 5718; 5; 11443; 5725 
1; 1906; 5721; 5; 11449; 5728 
1; 1907; 5724; 5; 11455; 5731 
1; 1908; 5727; 5; 11461; 5734 
1; 1909; 5730; 5; 11467; 5737 
1; 1910; 5733; 5; 11473; 5740 
1; 1911; 5736; 5; 11479; 5743 
1; 1912; 5739; 5; 11485; 5746 
1; 1913; 5742; 5; 11491; 5749 
1; 1914; 5745; 5; 11497; 5752 
1; 1915; 5748; 5; 11503; 5755 
1; 1916; 5751; 5; 11509; 5758 
1; 1917; 5754; 5; 11515; 5761 
1; 1918; 5757; 5; 11521; 5764 
1; 1919; 5760; 5; 11527; 5767 
1; 1920; 5763; 5; 11533; 5770 
1; 1921; 5766; 5; 11539; 5773 
1; 1922; 5769; 5; 11545; 5776 
1; 1923; 5772; 5; 11551; 5779 
1; 1924; 5775; 5; 11557; 5782 
1; 1925; 5778; 5; 11563; 5785 
1; 1926; 5781; 5; 11569; 5788 
1; 1927; 5784; 5; 11575; 5791 
1; 1928; 5787; 5; 11581; 5794 
1; 1929; 5790; 5; 11587; 5797 
1; 1930; 5793; 5; 11593; 5800 
1; 1931; 5796; 5; 11599; 5803 
1; 1932; 5799; 5; 11605; 5806 
1; 1933; 5802; 5; 11611; 5809 
1; 1934; 5805; 5; 11617; 5812 
1; 1935; 5808; 5; 11623; 5815 
1; 1936; 5811; 5; 11629; 5818 
1; 1937; 5814; 5; 11635; 5821 
1; 1938; 5817; 5; 11641; 5824 
1; 1939; 5820; 5; 11647; 5827 
1; 1940; 5823; 5; 11653; 5830 
1; 1941; 5826; 5; 11659; 5833 
1; 1942; 5829; 5; 11665; 5836 
1; 1943; 5832; 5; 11671; 5839 
1; 1944; 5835; 5; 11677; 5842 
1; 1945; 5838; 5; 11683; 5845 
1; 1946; 5841; 5; 11689; 5848 
1; 1947; 5844; 5; 11695; 5851 
1; 1948; 5847; 5; 11701; 5854 
1; 1949; 5850; 5; 11707; 5857 
1; 1950; 5853; 5; 11713; 5860 
1; 1951; 5856; 5; 11719; 5863 
1; 1952; 5859; 5; 11725; 5866 
1; 1953; 5862; 5; 11731; 5869 
1; 1954; 5865; 5; 11737; 5872 
1; 1955; 5868; 5; 11743; 5875 
1; 1956; 5871; 5; 11749; 5878 
1; 1957; 5874; 5; 11755; 5881 
1; 1958; 5877; 5; 11761; 5884 
1; 1959; 5880; 5; 11767; 5887 
1; 1960; 5883; 5; 11773; 5890 
1; 1961; 5886; 5; 11779; 5893 
1; 1962; 5889; 5; 11785; 5896 
1; 1963; 5892; 5; 11791; 5899 
1; 1964; 5895; 5; 11797; 5902 
1; 1965; 5898; 5; 11803; 5905 
1; 1966; 5901; 5; 11809; 5908 
1; 1967; 5904; 5; 11815; 5911 
1; 1968; 5907; 5; 11821; 5914 
1; 1969; 5910; 5; 11827; 5917 
1; 1970; 5913; 5; 11833; 5920 
1; 1971; 5916; 5; 11839; 5923 
1; 1972; 5919; 5; 11845; 5926 
1; 1973; 5922; 5; 11851; 5929 
1; 1974; 5925; 5; 11857; 5932 
1; 1975; 5928; 5; 11863; 5935 
1; 1976; 5931; 5; 11869; 5938 
1; 1977; 5934; 5; 11875; 5941 
1; 1978; 5937; 5; 11881; 5944 
1; 1979; 5940; 5; 11887; 5947 
1; 1980; 5943; 5; 11893; 5950 
1; 1981; 5946; 5; 11899; 5953 
1; 1982; 5949; 5; 11905; 5956 
1; 1983; 5952; 5; 11911; 5959 
1; 1984; 5955; 5; 11917; 5962 
1; 1985; 5958; 5; 11923; 5965 
1; 1986; 5961; 5; 11929; 5968 
1; 1987; 5964; 5; 11935; 5971 
1; 1988; 5967; 5; 11941; 5974 
1; 1989; 5970; 5; 11947; 5977 
1; 1990; 5973; 5; 11953; 5980 
1; 1991; 5976; 5; 11959; 5983 
1; 1992; 5979; 5; 11965; 5986 
1; 1993; 5982; 5; 11971; 5989 
1; 1994; 5985; 5; 11977; 5992 
1; 1995; 5988; 5; 11983; 5995 
1; 1996; 5991; 5; 11989; 5998 
1; 1997; 5994; 5; 11995; 6001 
1; 1998; 5997; 5; 12001; 6004 
1; 1999; 6000; 5; 12007; 6007 
1; 2000; 6003; 5; 12013; 6010 
