Grupo; Processo; Inst. Chegada; Tempo de Servi√ßo; Inst. Atendimento; Tempo Perm. Fila 
Grupo 1 
1; 1; 6; 5; 8; 2 
1; 2; 9; 5; 13; 4 
1; 3; 12; 5; 18; 6 
1; 4; 15; 5; 23; 8 
1; 5; 18; 5; 28; 10 
1; 6; 21; 5; 33; 12 
1; 7; 24; 5; 38; 14 
1; 8; 27; 5; 15; -12 
1; 9; 30; 5; 20; -10 
1; 10; 33; 5; 25; -8 
1; 11; 36; 5; 30; -6 
1; 12; 39; 5; 35; -4 
1; 13; 42; 5; 15; -27 
1; 14; 45; 5; 20; -25 
1; 15; 48; 5; 25; -23 
1; 16; 51; 5; 30; -21 
1; 17; 54; 5; 35; -19 
1; 18; 57; 5; 15; -42 
1; 19; 60; 5; 20; -40 
1; 20; 63; 5; 25; -38 
1; 21; 66; 5; 30; -36 
1; 22; 69; 5; 35; -34 
1; 23; 72; 5; 15; -57 
1; 24; 75; 5; 20; -55 
1; 25; 78; 5; 25; -53 
1; 26; 81; 5; 30; -51 
1; 27; 84; 5; 35; -49 
1; 28; 87; 5; 15; -72 
1; 29; 90; 5; 20; -70 
1; 30; 93; 5; 25; -68 
1; 31; 96; 5; 30; -66 
1; 32; 99; 5; 35; -64 
1; 33; 102; 5; 15; -87 
1; 34; 105; 5; 20; -85 
1; 35; 108; 5; 25; -83 
1; 36; 111; 5; 30; -81 
1; 37; 114; 5; 35; -79 
1; 38; 117; 5; 15; -102 
1; 39; 120; 5; 20; -100 
1; 40; 123; 5; 25; -98 
1; 41; 126; 5; 30; -96 
1; 42; 129; 5; 35; -94 
1; 43; 132; 5; 15; -117 
1; 44; 135; 5; 20; -115 
1; 45; 138; 5; 25; -113 
1; 46; 141; 5; 30; -111 
1; 47; 144; 5; 35; -109 
1; 48; 147; 5; 15; -132 
1; 49; 150; 5; 20; -130 
1; 50; 153; 5; 25; -128 
1; 51; 156; 5; 30; -126 
1; 52; 159; 5; 35; -124 
1; 53; 162; 5; 15; -147 
1; 54; 165; 5; 20; -145 
1; 55; 168; 5; 25; -143 
1; 56; 171; 5; 30; -141 
1; 57; 174; 5; 35; -139 
1; 58; 177; 5; 15; -162 
1; 59; 180; 5; 20; -160 
1; 60; 183; 5; 25; -158 
1; 61; 186; 5; 30; -156 
1; 62; 189; 5; 35; -154 
1; 63; 192; 5; 15; -177 
1; 64; 195; 5; 20; -175 
1; 65; 198; 5; 25; -173 
1; 66; 201; 5; 30; -171 
1; 67; 204; 5; 35; -169 
1; 68; 207; 5; 15; -192 
1; 69; 210; 5; 20; -190 
1; 70; 213; 5; 25; -188 
1; 71; 216; 5; 30; -186 
1; 72; 219; 5; 35; -184 
1; 73; 222; 5; 15; -207 
1; 74; 225; 5; 20; -205 
1; 75; 228; 5; 25; -203 
1; 76; 231; 5; 30; -201 
1; 77; 234; 5; 35; -199 
1; 78; 237; 5; 15; -222 
1; 79; 240; 5; 20; -220 
1; 80; 243; 5; 25; -218 
1; 81; 246; 5; 30; -216 
1; 82; 249; 5; 35; -214 
1; 83; 252; 5; 15; -237 
1; 84; 255; 5; 20; -235 
1; 85; 258; 5; 25; -233 
1; 86; 261; 5; 30; -231 
1; 87; 264; 5; 35; -229 
1; 88; 267; 5; 15; -252 
1; 89; 270; 5; 20; -250 
1; 90; 273; 5; 25; -248 
1; 91; 276; 5; 30; -246 
1; 92; 279; 5; 35; -244 
1; 93; 282; 5; 15; -267 
1; 94; 285; 5; 20; -265 
1; 95; 288; 5; 25; -263 
1; 96; 291; 5; 30; -261 
1; 97; 294; 5; 35; -259 
1; 98; 297; 5; 15; -282 
1; 99; 300; 5; 20; -280 
1; 100; 303; 5; 25; -278 
1; 101; 306; 5; 30; -276 
1; 102; 309; 5; 35; -274 
1; 103; 312; 5; 15; -297 
1; 104; 315; 5; 20; -295 
1; 105; 318; 5; 25; -293 
1; 106; 321; 5; 30; -291 
1; 107; 324; 5; 35; -289 
1; 108; 327; 5; 15; -312 
1; 109; 330; 5; 20; -310 
1; 110; 333; 5; 25; -308 
1; 111; 336; 5; 30; -306 
1; 112; 339; 5; 35; -304 
1; 113; 342; 5; 15; -327 
1; 114; 345; 5; 20; -325 
1; 115; 348; 5; 25; -323 
1; 116; 351; 5; 30; -321 
1; 117; 354; 5; 35; -319 
1; 118; 357; 5; 15; -342 
1; 119; 360; 5; 20; -340 
1; 120; 363; 5; 25; -338 
1; 121; 366; 5; 30; -336 
1; 122; 369; 5; 35; -334 
1; 123; 372; 5; 15; -357 
1; 124; 375; 5; 20; -355 
1; 125; 378; 5; 25; -353 
1; 126; 381; 5; 30; -351 
1; 127; 384; 5; 35; -349 
1; 128; 387; 5; 15; -372 
1; 129; 390; 5; 20; -370 
1; 130; 393; 5; 25; -368 
1; 131; 396; 5; 30; -366 
1; 132; 399; 5; 35; -364 
1; 133; 402; 5; 15; -387 
1; 134; 405; 5; 20; -385 
1; 135; 408; 5; 25; -383 
1; 136; 411; 5; 30; -381 
1; 137; 414; 5; 35; -379 
1; 138; 417; 5; 15; -402 
1; 139; 420; 5; 20; -400 
1; 140; 423; 5; 25; -398 
1; 141; 426; 5; 30; -396 
1; 142; 429; 5; 35; -394 
1; 143; 432; 5; 15; -417 
1; 144; 435; 5; 20; -415 
1; 145; 438; 5; 25; -413 
1; 146; 441; 5; 30; -411 
1; 147; 444; 5; 35; -409 
1; 148; 447; 5; 15; -432 
1; 149; 450; 5; 20; -430 
1; 150; 453; 5; 25; -428 
1; 151; 456; 5; 30; -426 
1; 152; 459; 5; 35; -424 
1; 153; 462; 5; 15; -447 
1; 154; 465; 5; 20; -445 
1; 155; 468; 5; 25; -443 
1; 156; 471; 5; 30; -441 
1; 157; 474; 5; 35; -439 
1; 158; 477; 5; 15; -462 
1; 159; 480; 5; 20; -460 
1; 160; 483; 5; 25; -458 
1; 161; 486; 5; 30; -456 
1; 162; 489; 5; 35; -454 
1; 163; 492; 5; 15; -477 
1; 164; 495; 5; 20; -475 
1; 165; 498; 5; 25; -473 
1; 166; 501; 5; 30; -471 
1; 167; 504; 5; 35; -469 
1; 168; 507; 5; 15; -492 
1; 169; 510; 5; 20; -490 
1; 170; 513; 5; 25; -488 
1; 171; 516; 5; 30; -486 
1; 172; 519; 5; 35; -484 
1; 173; 522; 5; 15; -507 
1; 174; 525; 5; 20; -505 
1; 175; 528; 5; 25; -503 
1; 176; 531; 5; 30; -501 
1; 177; 534; 5; 35; -499 
1; 178; 537; 5; 15; -522 
1; 179; 540; 5; 20; -520 
1; 180; 543; 5; 25; -518 
1; 181; 546; 5; 30; -516 
1; 182; 549; 5; 35; -514 
1; 183; 552; 5; 15; -537 
1; 184; 555; 5; 20; -535 
1; 185; 558; 5; 25; -533 
1; 186; 561; 5; 30; -531 
1; 187; 564; 5; 35; -529 
1; 188; 567; 5; 15; -552 
1; 189; 570; 5; 20; -550 
1; 190; 573; 5; 25; -548 
1; 191; 576; 5; 30; -546 
1; 192; 579; 5; 35; -544 
1; 193; 582; 5; 15; -567 
1; 194; 585; 5; 20; -565 
1; 195; 588; 5; 25; -563 
1; 196; 591; 5; 30; -561 
1; 197; 594; 5; 35; -559 
1; 198; 597; 5; 15; -582 
1; 199; 600; 5; 20; -580 
1; 200; 603; 5; 25; -578 
1; 201; 606; 5; 30; -576 
1; 202; 609; 5; 35; -574 
1; 203; 612; 5; 15; -597 
1; 204; 615; 5; 20; -595 
1; 205; 618; 5; 25; -593 
1; 206; 621; 5; 30; -591 
1; 207; 624; 5; 35; -589 
1; 208; 627; 5; 15; -612 
1; 209; 630; 5; 20; -610 
1; 210; 633; 5; 25; -608 
1; 211; 636; 5; 30; -606 
1; 212; 639; 5; 35; -604 
1; 213; 642; 5; 15; -627 
1; 214; 645; 5; 20; -625 
1; 215; 648; 5; 25; -623 
1; 216; 651; 5; 30; -621 
1; 217; 654; 5; 35; -619 
1; 218; 657; 5; 15; -642 
1; 219; 660; 5; 20; -640 
1; 220; 663; 5; 25; -638 
1; 221; 666; 5; 30; -636 
1; 222; 669; 5; 35; -634 
1; 223; 672; 5; 15; -657 
1; 224; 675; 5; 20; -655 
1; 225; 678; 5; 25; -653 
1; 226; 681; 5; 30; -651 
1; 227; 684; 5; 35; -649 
1; 228; 687; 5; 15; -672 
1; 229; 690; 5; 20; -670 
1; 230; 693; 5; 25; -668 
1; 231; 696; 5; 30; -666 
1; 232; 699; 5; 35; -664 
1; 233; 702; 5; 15; -687 
1; 234; 705; 5; 20; -685 
1; 235; 708; 5; 25; -683 
1; 236; 711; 5; 30; -681 
1; 237; 714; 5; 35; -679 
1; 238; 717; 5; 15; -702 
1; 239; 720; 5; 20; -700 
1; 240; 723; 5; 25; -698 
1; 241; 726; 5; 30; -696 
1; 242; 729; 5; 35; -694 
1; 243; 732; 5; 15; -717 
1; 244; 735; 5; 20; -715 
1; 245; 738; 5; 25; -713 
1; 246; 741; 5; 30; -711 
1; 247; 744; 5; 35; -709 
1; 248; 747; 5; 15; -732 
1; 249; 750; 5; 20; -730 
1; 250; 753; 5; 25; -728 
1; 251; 756; 5; 30; -726 
1; 252; 759; 5; 35; -724 
1; 253; 762; 5; 15; -747 
1; 254; 765; 5; 20; -745 
1; 255; 768; 5; 25; -743 
1; 256; 771; 5; 30; -741 
1; 257; 774; 5; 35; -739 
1; 258; 777; 5; 15; -762 
1; 259; 780; 5; 20; -760 
1; 260; 783; 5; 25; -758 
1; 261; 786; 5; 30; -756 
1; 262; 789; 5; 35; -754 
1; 263; 792; 5; 15; -777 
1; 264; 795; 5; 20; -775 
1; 265; 798; 5; 25; -773 
1; 266; 801; 5; 30; -771 
1; 267; 804; 5; 35; -769 
1; 268; 807; 5; 15; -792 
1; 269; 810; 5; 20; -790 
1; 270; 813; 5; 25; -788 
1; 271; 816; 5; 30; -786 
1; 272; 819; 5; 35; -784 
1; 273; 822; 5; 15; -807 
1; 274; 825; 5; 20; -805 
1; 275; 828; 5; 25; -803 
1; 276; 831; 5; 30; -801 
1; 277; 834; 5; 35; -799 
1; 278; 837; 5; 15; -822 
1; 279; 840; 5; 20; -820 
1; 280; 843; 5; 25; -818 
1; 281; 846; 5; 30; -816 
1; 282; 849; 5; 35; -814 
1; 283; 852; 5; 15; -837 
1; 284; 855; 5; 20; -835 
1; 285; 858; 5; 25; -833 
1; 286; 861; 5; 30; -831 
1; 287; 864; 5; 35; -829 
1; 288; 867; 5; 15; -852 
1; 289; 870; 5; 20; -850 
1; 290; 873; 5; 25; -848 
1; 291; 876; 5; 30; -846 
1; 292; 879; 5; 35; -844 
1; 293; 882; 5; 15; -867 
1; 294; 885; 5; 20; -865 
1; 295; 888; 5; 25; -863 
1; 296; 891; 5; 30; -861 
1; 297; 894; 5; 35; -859 
1; 298; 897; 5; 15; -882 
1; 299; 900; 5; 20; -880 
1; 300; 903; 5; 25; -878 
1; 301; 906; 5; 30; -876 
1; 302; 909; 5; 35; -874 
1; 303; 912; 5; 15; -897 
1; 304; 915; 5; 20; -895 
1; 305; 918; 5; 25; -893 
1; 306; 921; 5; 30; -891 
1; 307; 924; 5; 35; -889 
1; 308; 927; 5; 15; -912 
1; 309; 930; 5; 20; -910 
1; 310; 933; 5; 25; -908 
1; 311; 936; 5; 30; -906 
1; 312; 939; 5; 35; -904 
1; 313; 942; 5; 15; -927 
1; 314; 945; 5; 20; -925 
1; 315; 948; 5; 25; -923 
1; 316; 951; 5; 30; -921 
1; 317; 954; 5; 35; -919 
1; 318; 957; 5; 15; -942 
1; 319; 960; 5; 20; -940 
1; 320; 963; 5; 25; -938 
1; 321; 966; 5; 30; -936 
1; 322; 969; 5; 35; -934 
1; 323; 972; 5; 15; -957 
1; 324; 975; 5; 20; -955 
1; 325; 978; 5; 25; -953 
1; 326; 981; 5; 30; -951 
1; 327; 984; 5; 35; -949 
1; 328; 987; 5; 15; -972 
1; 329; 990; 5; 20; -970 
1; 330; 993; 5; 25; -968 
1; 331; 996; 5; 30; -966 
1; 332; 999; 5; 35; -964 
1; 333; 1002; 5; 15; -987 
1; 334; 1005; 5; 20; -985 
1; 335; 1008; 5; 25; -983 
1; 336; 1011; 5; 30; -981 
1; 337; 1014; 5; 35; -979 
1; 338; 1017; 5; 15; -1002 
1; 339; 1020; 5; 20; -1000 
1; 340; 1023; 5; 25; -998 
1; 341; 1026; 5; 30; -996 
1; 342; 1029; 5; 35; -994 
1; 343; 1032; 5; 15; -1017 
1; 344; 1035; 5; 20; -1015 
1; 345; 1038; 5; 25; -1013 
1; 346; 1041; 5; 30; -1011 
1; 347; 1044; 5; 35; -1009 
1; 348; 1047; 5; 15; -1032 
1; 349; 1050; 5; 20; -1030 
1; 350; 1053; 5; 25; -1028 
1; 351; 1056; 5; 30; -1026 
1; 352; 1059; 5; 35; -1024 
1; 353; 1062; 5; 15; -1047 
1; 354; 1065; 5; 20; -1045 
1; 355; 1068; 5; 25; -1043 
1; 356; 1071; 5; 30; -1041 
1; 357; 1074; 5; 35; -1039 
1; 358; 1077; 5; 15; -1062 
1; 359; 1080; 5; 20; -1060 
1; 360; 1083; 5; 25; -1058 
1; 361; 1086; 5; 30; -1056 
1; 362; 1089; 5; 35; -1054 
1; 363; 1092; 5; 15; -1077 
1; 364; 1095; 5; 20; -1075 
1; 365; 1098; 5; 25; -1073 
1; 366; 1101; 5; 30; -1071 
1; 367; 1104; 5; 35; -1069 
1; 368; 1107; 5; 15; -1092 
1; 369; 1110; 5; 20; -1090 
1; 370; 1113; 5; 25; -1088 
1; 371; 1116; 5; 30; -1086 
1; 372; 1119; 5; 35; -1084 
1; 373; 1122; 5; 15; -1107 
1; 374; 1125; 5; 20; -1105 
1; 375; 1128; 5; 25; -1103 
1; 376; 1131; 5; 30; -1101 
1; 377; 1134; 5; 35; -1099 
1; 378; 1137; 5; 15; -1122 
1; 379; 1140; 5; 20; -1120 
1; 380; 1143; 5; 25; -1118 
1; 381; 1146; 5; 30; -1116 
1; 382; 1149; 5; 35; -1114 
1; 383; 1152; 5; 15; -1137 
1; 384; 1155; 5; 20; -1135 
1; 385; 1158; 5; 25; -1133 
1; 386; 1161; 5; 30; -1131 
1; 387; 1164; 5; 35; -1129 
1; 388; 1167; 5; 15; -1152 
1; 389; 1170; 5; 20; -1150 
1; 390; 1173; 5; 25; -1148 
1; 391; 1176; 5; 30; -1146 
1; 392; 1179; 5; 35; -1144 
1; 393; 1182; 5; 15; -1167 
1; 394; 1185; 5; 20; -1165 
1; 395; 1188; 5; 25; -1163 
1; 396; 1191; 5; 30; -1161 
1; 397; 1194; 5; 35; -1159 
1; 398; 1197; 5; 15; -1182 
1; 399; 1200; 5; 20; -1180 
1; 400; 1203; 5; 25; -1178 
1; 401; 1206; 5; 30; -1176 
1; 402; 1209; 5; 35; -1174 
1; 403; 1212; 5; 15; -1197 
1; 404; 1215; 5; 20; -1195 
1; 405; 1218; 5; 25; -1193 
1; 406; 1221; 5; 30; -1191 
1; 407; 1224; 5; 35; -1189 
1; 408; 1227; 5; 15; -1212 
1; 409; 1230; 5; 20; -1210 
1; 410; 1233; 5; 25; -1208 
1; 411; 1236; 5; 30; -1206 
1; 412; 1239; 5; 35; -1204 
1; 413; 1242; 5; 15; -1227 
1; 414; 1245; 5; 20; -1225 
1; 415; 1248; 5; 25; -1223 
1; 416; 1251; 5; 30; -1221 
1; 417; 1254; 5; 35; -1219 
1; 418; 1257; 5; 15; -1242 
1; 419; 1260; 5; 20; -1240 
1; 420; 1263; 5; 25; -1238 
1; 421; 1266; 5; 30; -1236 
1; 422; 1269; 5; 35; -1234 
1; 423; 1272; 5; 15; -1257 
1; 424; 1275; 5; 20; -1255 
1; 425; 1278; 5; 25; -1253 
1; 426; 1281; 5; 30; -1251 
1; 427; 1284; 5; 35; -1249 
1; 428; 1287; 5; 15; -1272 
1; 429; 1290; 5; 20; -1270 
1; 430; 1293; 5; 25; -1268 
1; 431; 1296; 5; 30; -1266 
1; 432; 1299; 5; 35; -1264 
1; 433; 1302; 5; 15; -1287 
1; 434; 1305; 5; 20; -1285 
1; 435; 1308; 5; 25; -1283 
1; 436; 1311; 5; 30; -1281 
1; 437; 1314; 5; 35; -1279 
1; 438; 1317; 5; 15; -1302 
1; 439; 1320; 5; 20; -1300 
1; 440; 1323; 5; 25; -1298 
1; 441; 1326; 5; 30; -1296 
1; 442; 1329; 5; 35; -1294 
1; 443; 1332; 5; 15; -1317 
1; 444; 1335; 5; 20; -1315 
1; 445; 1338; 5; 25; -1313 
1; 446; 1341; 5; 30; -1311 
1; 447; 1344; 5; 35; -1309 
1; 448; 1347; 5; 15; -1332 
1; 449; 1350; 5; 20; -1330 
1; 450; 1353; 5; 25; -1328 
1; 451; 1356; 5; 30; -1326 
1; 452; 1359; 5; 35; -1324 
1; 453; 1362; 5; 15; -1347 
1; 454; 1365; 5; 20; -1345 
1; 455; 1368; 5; 25; -1343 
1; 456; 1371; 5; 30; -1341 
1; 457; 1374; 5; 35; -1339 
1; 458; 1377; 5; 15; -1362 
1; 459; 1380; 5; 20; -1360 
1; 460; 1383; 5; 25; -1358 
1; 461; 1386; 5; 30; -1356 
1; 462; 1389; 5; 35; -1354 
1; 463; 1392; 5; 15; -1377 
1; 464; 1395; 5; 20; -1375 
1; 465; 1398; 5; 25; -1373 
1; 466; 1401; 5; 30; -1371 
1; 467; 1404; 5; 35; -1369 
1; 468; 1407; 5; 15; -1392 
1; 469; 1410; 5; 20; -1390 
1; 470; 1413; 5; 25; -1388 
1; 471; 1416; 5; 30; -1386 
1; 472; 1419; 5; 35; -1384 
1; 473; 1422; 5; 15; -1407 
1; 474; 1425; 5; 20; -1405 
1; 475; 1428; 5; 25; -1403 
1; 476; 1431; 5; 30; -1401 
1; 477; 1434; 5; 35; -1399 
1; 478; 1437; 5; 15; -1422 
1; 479; 1440; 5; 20; -1420 
1; 480; 1443; 5; 25; -1418 
1; 481; 1446; 5; 30; -1416 
1; 482; 1449; 5; 35; -1414 
1; 483; 1452; 5; 15; -1437 
1; 484; 1455; 5; 20; -1435 
1; 485; 1458; 5; 25; -1433 
1; 486; 1461; 5; 30; -1431 
1; 487; 1464; 5; 35; -1429 
1; 488; 1467; 5; 15; -1452 
1; 489; 1470; 5; 20; -1450 
1; 490; 1473; 5; 25; -1448 
1; 491; 1476; 5; 30; -1446 
1; 492; 1479; 5; 35; -1444 
1; 493; 1482; 5; 15; -1467 
1; 494; 1485; 5; 20; -1465 
1; 495; 1488; 5; 25; -1463 
1; 496; 1491; 5; 30; -1461 
1; 497; 1494; 5; 35; -1459 
1; 498; 1497; 5; 15; -1482 
1; 499; 1500; 5; 20; -1480 
1; 500; 1503; 5; 25; -1478 
1; 501; 1506; 5; 30; -1476 
1; 502; 1509; 5; 35; -1474 
1; 503; 1512; 5; 15; -1497 
1; 504; 1515; 5; 20; -1495 
1; 505; 1518; 5; 25; -1493 
1; 506; 1521; 5; 30; -1491 
1; 507; 1524; 5; 35; -1489 
1; 508; 1527; 5; 15; -1512 
1; 509; 1530; 5; 20; -1510 
1; 510; 1533; 5; 25; -1508 
1; 511; 1536; 5; 30; -1506 
1; 512; 1539; 5; 35; -1504 
1; 513; 1542; 5; 15; -1527 
1; 514; 1545; 5; 20; -1525 
1; 515; 1548; 5; 25; -1523 
1; 516; 1551; 5; 30; -1521 
1; 517; 1554; 5; 35; -1519 
1; 518; 1557; 5; 15; -1542 
1; 519; 1560; 5; 20; -1540 
1; 520; 1563; 5; 25; -1538 
1; 521; 1566; 5; 30; -1536 
1; 522; 1569; 5; 35; -1534 
1; 523; 1572; 5; 15; -1557 
1; 524; 1575; 5; 20; -1555 
1; 525; 1578; 5; 25; -1553 
1; 526; 1581; 5; 30; -1551 
1; 527; 1584; 5; 35; -1549 
1; 528; 1587; 5; 15; -1572 
1; 529; 1590; 5; 20; -1570 
1; 530; 1593; 5; 25; -1568 
1; 531; 1596; 5; 30; -1566 
1; 532; 1599; 5; 35; -1564 
1; 533; 1602; 5; 15; -1587 
1; 534; 1605; 5; 20; -1585 
1; 535; 1608; 5; 25; -1583 
1; 536; 1611; 5; 30; -1581 
1; 537; 1614; 5; 35; -1579 
1; 538; 1617; 5; 15; -1602 
1; 539; 1620; 5; 20; -1600 
1; 540; 1623; 5; 25; -1598 
1; 541; 1626; 5; 30; -1596 
1; 542; 1629; 5; 35; -1594 
1; 543; 1632; 5; 15; -1617 
1; 544; 1635; 5; 20; -1615 
1; 545; 1638; 5; 25; -1613 
1; 546; 1641; 5; 30; -1611 
1; 547; 1644; 5; 35; -1609 
1; 548; 1647; 5; 15; -1632 
1; 549; 1650; 5; 20; -1630 
1; 550; 1653; 5; 25; -1628 
1; 551; 1656; 5; 30; -1626 
1; 552; 1659; 5; 35; -1624 
1; 553; 1662; 5; 15; -1647 
1; 554; 1665; 5; 20; -1645 
1; 555; 1668; 5; 25; -1643 
1; 556; 1671; 5; 30; -1641 
1; 557; 1674; 5; 35; -1639 
1; 558; 1677; 5; 15; -1662 
1; 559; 1680; 5; 20; -1660 
1; 560; 1683; 5; 25; -1658 
1; 561; 1686; 5; 30; -1656 
1; 562; 1689; 5; 35; -1654 
1; 563; 1692; 5; 15; -1677 
1; 564; 1695; 5; 20; -1675 
1; 565; 1698; 5; 25; -1673 
1; 566; 1701; 5; 30; -1671 
1; 567; 1704; 5; 35; -1669 
1; 568; 1707; 5; 15; -1692 
1; 569; 1710; 5; 20; -1690 
1; 570; 1713; 5; 25; -1688 
1; 571; 1716; 5; 30; -1686 
1; 572; 1719; 5; 35; -1684 
1; 573; 1722; 5; 15; -1707 
1; 574; 1725; 5; 20; -1705 
1; 575; 1728; 5; 25; -1703 
1; 576; 1731; 5; 30; -1701 
1; 577; 1734; 5; 35; -1699 
1; 578; 1737; 5; 15; -1722 
1; 579; 1740; 5; 20; -1720 
1; 580; 1743; 5; 25; -1718 
1; 581; 1746; 5; 30; -1716 
1; 582; 1749; 5; 35; -1714 
1; 583; 1752; 5; 15; -1737 
1; 584; 1755; 5; 20; -1735 
1; 585; 1758; 5; 25; -1733 
1; 586; 1761; 5; 30; -1731 
1; 587; 1764; 5; 35; -1729 
1; 588; 1767; 5; 15; -1752 
1; 589; 1770; 5; 20; -1750 
1; 590; 1773; 5; 25; -1748 
1; 591; 1776; 5; 30; -1746 
1; 592; 1779; 5; 35; -1744 
1; 593; 1782; 5; 15; -1767 
1; 594; 1785; 5; 20; -1765 
1; 595; 1788; 5; 25; -1763 
1; 596; 1791; 5; 30; -1761 
1; 597; 1794; 5; 35; -1759 
1; 598; 1797; 5; 15; -1782 
1; 599; 1800; 5; 20; -1780 
1; 600; 1803; 5; 25; -1778 
1; 601; 1806; 5; 30; -1776 
1; 602; 1809; 5; 35; -1774 
1; 603; 1812; 5; 15; -1797 
1; 604; 1815; 5; 20; -1795 
1; 605; 1818; 5; 25; -1793 
1; 606; 1821; 5; 30; -1791 
1; 607; 1824; 5; 35; -1789 
1; 608; 1827; 5; 15; -1812 
1; 609; 1830; 5; 20; -1810 
1; 610; 1833; 5; 25; -1808 
1; 611; 1836; 5; 30; -1806 
1; 612; 1839; 5; 35; -1804 
1; 613; 1842; 5; 15; -1827 
1; 614; 1845; 5; 20; -1825 
1; 615; 1848; 5; 25; -1823 
1; 616; 1851; 5; 30; -1821 
1; 617; 1854; 5; 35; -1819 
1; 618; 1857; 5; 15; -1842 
1; 619; 1860; 5; 20; -1840 
1; 620; 1863; 5; 25; -1838 
1; 621; 1866; 5; 30; -1836 
1; 622; 1869; 5; 35; -1834 
1; 623; 1872; 5; 15; -1857 
1; 624; 1875; 5; 20; -1855 
1; 625; 1878; 5; 25; -1853 
1; 626; 1881; 5; 30; -1851 
1; 627; 1884; 5; 35; -1849 
1; 628; 1887; 5; 15; -1872 
1; 629; 1890; 5; 20; -1870 
1; 630; 1893; 5; 25; -1868 
1; 631; 1896; 5; 30; -1866 
1; 632; 1899; 5; 35; -1864 
1; 633; 1902; 5; 15; -1887 
1; 634; 1905; 5; 20; -1885 
1; 635; 1908; 5; 25; -1883 
1; 636; 1911; 5; 30; -1881 
1; 637; 1914; 5; 35; -1879 
1; 638; 1917; 5; 15; -1902 
1; 639; 1920; 5; 20; -1900 
1; 640; 1923; 5; 25; -1898 
1; 641; 1926; 5; 30; -1896 
1; 642; 1929; 5; 35; -1894 
1; 643; 1932; 5; 15; -1917 
1; 644; 1935; 5; 20; -1915 
1; 645; 1938; 5; 25; -1913 
1; 646; 1941; 5; 30; -1911 
1; 647; 1944; 5; 35; -1909 
1; 648; 1947; 5; 15; -1932 
1; 649; 1950; 5; 20; -1930 
1; 650; 1953; 5; 25; -1928 
1; 651; 1956; 5; 30; -1926 
1; 652; 1959; 5; 35; -1924 
1; 653; 1962; 5; 15; -1947 
1; 654; 1965; 5; 20; -1945 
1; 655; 1968; 5; 25; -1943 
1; 656; 1971; 5; 30; -1941 
1; 657; 1974; 5; 35; -1939 
1; 658; 1977; 5; 15; -1962 
1; 659; 1980; 5; 20; -1960 
1; 660; 1983; 5; 25; -1958 
1; 661; 1986; 5; 30; -1956 
1; 662; 1989; 5; 35; -1954 
1; 663; 1992; 5; 15; -1977 
1; 664; 1995; 5; 20; -1975 
1; 665; 1998; 5; 25; -1973 
1; 666; 2001; 5; 30; -1971 
1; 667; 2004; 5; 35; -1969 
1; 668; 2007; 5; 15; -1992 
1; 669; 2010; 5; 20; -1990 
1; 670; 2013; 5; 25; -1988 
1; 671; 2016; 5; 30; -1986 
1; 672; 2019; 5; 35; -1984 
1; 673; 2022; 5; 15; -2007 
1; 674; 2025; 5; 20; -2005 
1; 675; 2028; 5; 25; -2003 
1; 676; 2031; 5; 30; -2001 
1; 677; 2034; 5; 35; -1999 
1; 678; 2037; 5; 15; -2022 
1; 679; 2040; 5; 20; -2020 
1; 680; 2043; 5; 25; -2018 
1; 681; 2046; 5; 30; -2016 
1; 682; 2049; 5; 35; -2014 
1; 683; 2052; 5; 15; -2037 
1; 684; 2055; 5; 20; -2035 
1; 685; 2058; 5; 25; -2033 
1; 686; 2061; 5; 30; -2031 
1; 687; 2064; 5; 35; -2029 
1; 688; 2067; 5; 15; -2052 
1; 689; 2070; 5; 20; -2050 
1; 690; 2073; 5; 25; -2048 
1; 691; 2076; 5; 30; -2046 
1; 692; 2079; 5; 35; -2044 
1; 693; 2082; 5; 15; -2067 
1; 694; 2085; 5; 20; -2065 
1; 695; 2088; 5; 25; -2063 
1; 696; 2091; 5; 30; -2061 
1; 697; 2094; 5; 35; -2059 
1; 698; 2097; 5; 15; -2082 
1; 699; 2100; 5; 20; -2080 
1; 700; 2103; 5; 25; -2078 
1; 701; 2106; 5; 30; -2076 
1; 702; 2109; 5; 35; -2074 
1; 703; 2112; 5; 15; -2097 
1; 704; 2115; 5; 20; -2095 
1; 705; 2118; 5; 25; -2093 
1; 706; 2121; 5; 30; -2091 
1; 707; 2124; 5; 35; -2089 
1; 708; 2127; 5; 15; -2112 
1; 709; 2130; 5; 20; -2110 
1; 710; 2133; 5; 25; -2108 
1; 711; 2136; 5; 30; -2106 
1; 712; 2139; 5; 35; -2104 
1; 713; 2142; 5; 15; -2127 
1; 714; 2145; 5; 20; -2125 
1; 715; 2148; 5; 25; -2123 
1; 716; 2151; 5; 30; -2121 
1; 717; 2154; 5; 35; -2119 
1; 718; 2157; 5; 15; -2142 
1; 719; 2160; 5; 20; -2140 
1; 720; 2163; 5; 25; -2138 
1; 721; 2166; 5; 30; -2136 
1; 722; 2169; 5; 35; -2134 
1; 723; 2172; 5; 15; -2157 
1; 724; 2175; 5; 20; -2155 
1; 725; 2178; 5; 25; -2153 
1; 726; 2181; 5; 30; -2151 
1; 727; 2184; 5; 35; -2149 
1; 728; 2187; 5; 15; -2172 
1; 729; 2190; 5; 20; -2170 
1; 730; 2193; 5; 25; -2168 
1; 731; 2196; 5; 30; -2166 
1; 732; 2199; 5; 35; -2164 
1; 733; 2202; 5; 15; -2187 
1; 734; 2205; 5; 20; -2185 
1; 735; 2208; 5; 25; -2183 
1; 736; 2211; 5; 30; -2181 
1; 737; 2214; 5; 35; -2179 
1; 738; 2217; 5; 15; -2202 
1; 739; 2220; 5; 20; -2200 
1; 740; 2223; 5; 25; -2198 
1; 741; 2226; 5; 30; -2196 
1; 742; 2229; 5; 35; -2194 
1; 743; 2232; 5; 15; -2217 
1; 744; 2235; 5; 20; -2215 
1; 745; 2238; 5; 25; -2213 
1; 746; 2241; 5; 30; -2211 
1; 747; 2244; 5; 35; -2209 
1; 748; 2247; 5; 15; -2232 
1; 749; 2250; 5; 20; -2230 
1; 750; 2253; 5; 25; -2228 
1; 751; 2256; 5; 30; -2226 
1; 752; 2259; 5; 35; -2224 
1; 753; 2262; 5; 15; -2247 
1; 754; 2265; 5; 20; -2245 
1; 755; 2268; 5; 25; -2243 
1; 756; 2271; 5; 30; -2241 
1; 757; 2274; 5; 35; -2239 
1; 758; 2277; 5; 15; -2262 
1; 759; 2280; 5; 20; -2260 
1; 760; 2283; 5; 25; -2258 
1; 761; 2286; 5; 30; -2256 
1; 762; 2289; 5; 35; -2254 
1; 763; 2292; 5; 15; -2277 
1; 764; 2295; 5; 20; -2275 
1; 765; 2298; 5; 25; -2273 
1; 766; 2301; 5; 30; -2271 
1; 767; 2304; 5; 35; -2269 
1; 768; 2307; 5; 15; -2292 
1; 769; 2310; 5; 20; -2290 
1; 770; 2313; 5; 25; -2288 
1; 771; 2316; 5; 30; -2286 
1; 772; 2319; 5; 35; -2284 
1; 773; 2322; 5; 15; -2307 
1; 774; 2325; 5; 20; -2305 
1; 775; 2328; 5; 25; -2303 
1; 776; 2331; 5; 30; -2301 
1; 777; 2334; 5; 35; -2299 
1; 778; 2337; 5; 15; -2322 
1; 779; 2340; 5; 20; -2320 
1; 780; 2343; 5; 25; -2318 
1; 781; 2346; 5; 30; -2316 
1; 782; 2349; 5; 35; -2314 
1; 783; 2352; 5; 15; -2337 
1; 784; 2355; 5; 20; -2335 
1; 785; 2358; 5; 25; -2333 
1; 786; 2361; 5; 30; -2331 
1; 787; 2364; 5; 35; -2329 
1; 788; 2367; 5; 15; -2352 
1; 789; 2370; 5; 20; -2350 
1; 790; 2373; 5; 25; -2348 
1; 791; 2376; 5; 30; -2346 
1; 792; 2379; 5; 35; -2344 
1; 793; 2382; 5; 15; -2367 
1; 794; 2385; 5; 20; -2365 
1; 795; 2388; 5; 25; -2363 
1; 796; 2391; 5; 30; -2361 
1; 797; 2394; 5; 35; -2359 
1; 798; 2397; 5; 15; -2382 
1; 799; 2400; 5; 20; -2380 
1; 800; 2403; 5; 25; -2378 
1; 801; 2406; 5; 30; -2376 
1; 802; 2409; 5; 35; -2374 
1; 803; 2412; 5; 15; -2397 
1; 804; 2415; 5; 20; -2395 
1; 805; 2418; 5; 25; -2393 
1; 806; 2421; 5; 30; -2391 
1; 807; 2424; 5; 35; -2389 
1; 808; 2427; 5; 15; -2412 
1; 809; 2430; 5; 20; -2410 
1; 810; 2433; 5; 25; -2408 
1; 811; 2436; 5; 30; -2406 
1; 812; 2439; 5; 35; -2404 
1; 813; 2442; 5; 15; -2427 
1; 814; 2445; 5; 20; -2425 
1; 815; 2448; 5; 25; -2423 
1; 816; 2451; 5; 30; -2421 
1; 817; 2454; 5; 35; -2419 
1; 818; 2457; 5; 15; -2442 
1; 819; 2460; 5; 20; -2440 
1; 820; 2463; 5; 25; -2438 
1; 821; 2466; 5; 30; -2436 
1; 822; 2469; 5; 35; -2434 
1; 823; 2472; 5; 15; -2457 
1; 824; 2475; 5; 20; -2455 
1; 825; 2478; 5; 25; -2453 
1; 826; 2481; 5; 30; -2451 
1; 827; 2484; 5; 35; -2449 
1; 828; 2487; 5; 15; -2472 
1; 829; 2490; 5; 20; -2470 
1; 830; 2493; 5; 25; -2468 
1; 831; 2496; 5; 30; -2466 
1; 832; 2499; 5; 35; -2464 
1; 833; 2502; 5; 15; -2487 
1; 834; 2505; 5; 20; -2485 
1; 835; 2508; 5; 25; -2483 
1; 836; 2511; 5; 30; -2481 
1; 837; 2514; 5; 35; -2479 
1; 838; 2517; 5; 15; -2502 
1; 839; 2520; 5; 20; -2500 
1; 840; 2523; 5; 25; -2498 
1; 841; 2526; 5; 30; -2496 
1; 842; 2529; 5; 35; -2494 
1; 843; 2532; 5; 15; -2517 
1; 844; 2535; 5; 20; -2515 
1; 845; 2538; 5; 25; -2513 
1; 846; 2541; 5; 30; -2511 
1; 847; 2544; 5; 35; -2509 
1; 848; 2547; 5; 15; -2532 
1; 849; 2550; 5; 20; -2530 
1; 850; 2553; 5; 25; -2528 
1; 851; 2556; 5; 30; -2526 
1; 852; 2559; 5; 35; -2524 
1; 853; 2562; 5; 15; -2547 
1; 854; 2565; 5; 20; -2545 
1; 855; 2568; 5; 25; -2543 
1; 856; 2571; 5; 30; -2541 
1; 857; 2574; 5; 35; -2539 
1; 858; 2577; 5; 15; -2562 
1; 859; 2580; 5; 20; -2560 
1; 860; 2583; 5; 25; -2558 
1; 861; 2586; 5; 30; -2556 
1; 862; 2589; 5; 35; -2554 
1; 863; 2592; 5; 15; -2577 
1; 864; 2595; 5; 20; -2575 
1; 865; 2598; 5; 25; -2573 
1; 866; 2601; 5; 30; -2571 
1; 867; 2604; 5; 35; -2569 
1; 868; 2607; 5; 15; -2592 
1; 869; 2610; 5; 20; -2590 
1; 870; 2613; 5; 25; -2588 
1; 871; 2616; 5; 30; -2586 
1; 872; 2619; 5; 35; -2584 
1; 873; 2622; 5; 15; -2607 
1; 874; 2625; 5; 20; -2605 
1; 875; 2628; 5; 25; -2603 
1; 876; 2631; 5; 30; -2601 
1; 877; 2634; 5; 35; -2599 
1; 878; 2637; 5; 15; -2622 
1; 879; 2640; 5; 20; -2620 
1; 880; 2643; 5; 25; -2618 
1; 881; 2646; 5; 30; -2616 
1; 882; 2649; 5; 35; -2614 
1; 883; 2652; 5; 15; -2637 
1; 884; 2655; 5; 20; -2635 
1; 885; 2658; 5; 25; -2633 
1; 886; 2661; 5; 30; -2631 
1; 887; 2664; 5; 35; -2629 
1; 888; 2667; 5; 15; -2652 
1; 889; 2670; 5; 20; -2650 
1; 890; 2673; 5; 25; -2648 
1; 891; 2676; 5; 30; -2646 
1; 892; 2679; 5; 35; -2644 
1; 893; 2682; 5; 15; -2667 
1; 894; 2685; 5; 20; -2665 
1; 895; 2688; 5; 25; -2663 
1; 896; 2691; 5; 30; -2661 
1; 897; 2694; 5; 35; -2659 
1; 898; 2697; 5; 15; -2682 
1; 899; 2700; 5; 20; -2680 
1; 900; 2703; 5; 25; -2678 
1; 901; 2706; 5; 30; -2676 
1; 902; 2709; 5; 35; -2674 
1; 903; 2712; 5; 15; -2697 
1; 904; 2715; 5; 20; -2695 
1; 905; 2718; 5; 25; -2693 
1; 906; 2721; 5; 30; -2691 
1; 907; 2724; 5; 35; -2689 
1; 908; 2727; 5; 15; -2712 
1; 909; 2730; 5; 20; -2710 
1; 910; 2733; 5; 25; -2708 
1; 911; 2736; 5; 30; -2706 
1; 912; 2739; 5; 35; -2704 
1; 913; 2742; 5; 15; -2727 
1; 914; 2745; 5; 20; -2725 
1; 915; 2748; 5; 25; -2723 
1; 916; 2751; 5; 30; -2721 
1; 917; 2754; 5; 35; -2719 
1; 918; 2757; 5; 15; -2742 
1; 919; 2760; 5; 20; -2740 
1; 920; 2763; 5; 25; -2738 
1; 921; 2766; 5; 30; -2736 
1; 922; 2769; 5; 35; -2734 
1; 923; 2772; 5; 15; -2757 
1; 924; 2775; 5; 20; -2755 
1; 925; 2778; 5; 25; -2753 
1; 926; 2781; 5; 30; -2751 
1; 927; 2784; 5; 35; -2749 
1; 928; 2787; 5; 15; -2772 
1; 929; 2790; 5; 20; -2770 
1; 930; 2793; 5; 25; -2768 
1; 931; 2796; 5; 30; -2766 
1; 932; 2799; 5; 35; -2764 
1; 933; 2802; 5; 15; -2787 
1; 934; 2805; 5; 20; -2785 
1; 935; 2808; 5; 25; -2783 
1; 936; 2811; 5; 30; -2781 
1; 937; 2814; 5; 35; -2779 
1; 938; 2817; 5; 15; -2802 
1; 939; 2820; 5; 20; -2800 
1; 940; 2823; 5; 25; -2798 
1; 941; 2826; 5; 30; -2796 
1; 942; 2829; 5; 35; -2794 
1; 943; 2832; 5; 15; -2817 
1; 944; 2835; 5; 20; -2815 
1; 945; 2838; 5; 25; -2813 
1; 946; 2841; 5; 30; -2811 
1; 947; 2844; 5; 35; -2809 
1; 948; 2847; 5; 15; -2832 
1; 949; 2850; 5; 20; -2830 
1; 950; 2853; 5; 25; -2828 
1; 951; 2856; 5; 30; -2826 
1; 952; 2859; 5; 35; -2824 
1; 953; 2862; 5; 15; -2847 
1; 954; 2865; 5; 20; -2845 
1; 955; 2868; 5; 25; -2843 
1; 956; 2871; 5; 30; -2841 
1; 957; 2874; 5; 35; -2839 
1; 958; 2877; 5; 15; -2862 
1; 959; 2880; 5; 20; -2860 
1; 960; 2883; 5; 25; -2858 
1; 961; 2886; 5; 30; -2856 
1; 962; 2889; 5; 35; -2854 
1; 963; 2892; 5; 15; -2877 
1; 964; 2895; 5; 20; -2875 
1; 965; 2898; 5; 25; -2873 
1; 966; 2901; 5; 30; -2871 
1; 967; 2904; 5; 35; -2869 
1; 968; 2907; 5; 15; -2892 
1; 969; 2910; 5; 20; -2890 
1; 970; 2913; 5; 25; -2888 
1; 971; 2916; 5; 30; -2886 
1; 972; 2919; 5; 35; -2884 
1; 973; 2922; 5; 15; -2907 
1; 974; 2925; 5; 20; -2905 
1; 975; 2928; 5; 25; -2903 
1; 976; 2931; 5; 30; -2901 
1; 977; 2934; 5; 35; -2899 
1; 978; 2937; 5; 15; -2922 
1; 979; 2940; 5; 20; -2920 
1; 980; 2943; 5; 25; -2918 
1; 981; 2946; 5; 30; -2916 
1; 982; 2949; 5; 35; -2914 
1; 983; 2952; 5; 15; -2937 
1; 984; 2955; 5; 20; -2935 
1; 985; 2958; 5; 25; -2933 
1; 986; 2961; 5; 30; -2931 
1; 987; 2964; 5; 35; -2929 
1; 988; 2967; 5; 15; -2952 
1; 989; 2970; 5; 20; -2950 
1; 990; 2973; 5; 25; -2948 
1; 991; 2976; 5; 30; -2946 
1; 992; 2979; 5; 35; -2944 
1; 993; 2982; 5; 15; -2967 
1; 994; 2985; 5; 20; -2965 
1; 995; 2988; 5; 25; -2963 
1; 996; 2991; 5; 30; -2961 
1; 997; 2994; 5; 35; -2959 
1; 998; 2997; 5; 15; -2982 
1; 999; 3000; 5; 20; -2980 
1; 1000; 3003; 5; 25; -2978 
1; 1001; 3006; 5; 30; -2976 
1; 1002; 3009; 5; 35; -2974 
1; 1003; 3012; 5; 15; -2997 
1; 1004; 3015; 5; 20; -2995 
1; 1005; 3018; 5; 25; -2993 
1; 1006; 3021; 5; 30; -2991 
1; 1007; 3024; 5; 35; -2989 
1; 1008; 3027; 5; 15; -3012 
1; 1009; 3030; 5; 20; -3010 
1; 1010; 3033; 5; 25; -3008 
1; 1011; 3036; 5; 30; -3006 
1; 1012; 3039; 5; 35; -3004 
1; 1013; 3042; 5; 15; -3027 
1; 1014; 3045; 5; 20; -3025 
1; 1015; 3048; 5; 25; -3023 
1; 1016; 3051; 5; 30; -3021 
1; 1017; 3054; 5; 35; -3019 
1; 1018; 3057; 5; 15; -3042 
1; 1019; 3060; 5; 20; -3040 
1; 1020; 3063; 5; 25; -3038 
1; 1021; 3066; 5; 30; -3036 
1; 1022; 3069; 5; 35; -3034 
1; 1023; 3072; 5; 15; -3057 
1; 1024; 3075; 5; 20; -3055 
1; 1025; 3078; 5; 25; -3053 
1; 1026; 3081; 5; 30; -3051 
1; 1027; 3084; 5; 35; -3049 
1; 1028; 3087; 5; 15; -3072 
1; 1029; 3090; 5; 20; -3070 
1; 1030; 3093; 5; 25; -3068 
1; 1031; 3096; 5; 30; -3066 
1; 1032; 3099; 5; 35; -3064 
1; 1033; 3102; 5; 15; -3087 
1; 1034; 3105; 5; 20; -3085 
1; 1035; 3108; 5; 25; -3083 
1; 1036; 3111; 5; 30; -3081 
1; 1037; 3114; 5; 35; -3079 
1; 1038; 3117; 5; 15; -3102 
1; 1039; 3120; 5; 20; -3100 
1; 1040; 3123; 5; 25; -3098 
1; 1041; 3126; 5; 30; -3096 
1; 1042; 3129; 5; 35; -3094 
1; 1043; 3132; 5; 15; -3117 
1; 1044; 3135; 5; 20; -3115 
1; 1045; 3138; 5; 25; -3113 
1; 1046; 3141; 5; 30; -3111 
1; 1047; 3144; 5; 35; -3109 
1; 1048; 3147; 5; 15; -3132 
1; 1049; 3150; 5; 20; -3130 
1; 1050; 3153; 5; 25; -3128 
1; 1051; 3156; 5; 30; -3126 
1; 1052; 3159; 5; 35; -3124 
1; 1053; 3162; 5; 15; -3147 
1; 1054; 3165; 5; 20; -3145 
1; 1055; 3168; 5; 25; -3143 
1; 1056; 3171; 5; 30; -3141 
1; 1057; 3174; 5; 35; -3139 
1; 1058; 3177; 5; 15; -3162 
1; 1059; 3180; 5; 20; -3160 
1; 1060; 3183; 5; 25; -3158 
1; 1061; 3186; 5; 30; -3156 
1; 1062; 3189; 5; 35; -3154 
1; 1063; 3192; 5; 15; -3177 
1; 1064; 3195; 5; 20; -3175 
1; 1065; 3198; 5; 25; -3173 
1; 1066; 3201; 5; 30; -3171 
1; 1067; 3204; 5; 35; -3169 
1; 1068; 3207; 5; 15; -3192 
1; 1069; 3210; 5; 20; -3190 
1; 1070; 3213; 5; 25; -3188 
1; 1071; 3216; 5; 30; -3186 
1; 1072; 3219; 5; 35; -3184 
1; 1073; 3222; 5; 15; -3207 
1; 1074; 3225; 5; 20; -3205 
1; 1075; 3228; 5; 25; -3203 
1; 1076; 3231; 5; 30; -3201 
1; 1077; 3234; 5; 35; -3199 
1; 1078; 3237; 5; 15; -3222 
1; 1079; 3240; 5; 20; -3220 
1; 1080; 3243; 5; 25; -3218 
1; 1081; 3246; 5; 30; -3216 
1; 1082; 3249; 5; 35; -3214 
1; 1083; 3252; 5; 15; -3237 
1; 1084; 3255; 5; 20; -3235 
1; 1085; 3258; 5; 25; -3233 
1; 1086; 3261; 5; 30; -3231 
1; 1087; 3264; 5; 35; -3229 
1; 1088; 3267; 5; 15; -3252 
1; 1089; 3270; 5; 20; -3250 
1; 1090; 3273; 5; 25; -3248 
1; 1091; 3276; 5; 30; -3246 
1; 1092; 3279; 5; 35; -3244 
1; 1093; 3282; 5; 15; -3267 
1; 1094; 3285; 5; 20; -3265 
1; 1095; 3288; 5; 25; -3263 
1; 1096; 3291; 5; 30; -3261 
1; 1097; 3294; 5; 35; -3259 
1; 1098; 3297; 5; 15; -3282 
1; 1099; 3300; 5; 20; -3280 
1; 1100; 3303; 5; 25; -3278 
1; 1101; 3306; 5; 30; -3276 
1; 1102; 3309; 5; 35; -3274 
1; 1103; 3312; 5; 15; -3297 
1; 1104; 3315; 5; 20; -3295 
1; 1105; 3318; 5; 25; -3293 
1; 1106; 3321; 5; 30; -3291 
1; 1107; 3324; 5; 35; -3289 
1; 1108; 3327; 5; 15; -3312 
1; 1109; 3330; 5; 20; -3310 
1; 1110; 3333; 5; 25; -3308 
1; 1111; 3336; 5; 30; -3306 
1; 1112; 3339; 5; 35; -3304 
1; 1113; 3342; 5; 15; -3327 
1; 1114; 3345; 5; 20; -3325 
1; 1115; 3348; 5; 25; -3323 
1; 1116; 3351; 5; 30; -3321 
1; 1117; 3354; 5; 35; -3319 
1; 1118; 3357; 5; 15; -3342 
1; 1119; 3360; 5; 20; -3340 
1; 1120; 3363; 5; 25; -3338 
1; 1121; 3366; 5; 30; -3336 
1; 1122; 3369; 5; 35; -3334 
1; 1123; 3372; 5; 15; -3357 
1; 1124; 3375; 5; 20; -3355 
1; 1125; 3378; 5; 25; -3353 
1; 1126; 3381; 5; 30; -3351 
1; 1127; 3384; 5; 35; -3349 
1; 1128; 3387; 5; 15; -3372 
1; 1129; 3390; 5; 20; -3370 
1; 1130; 3393; 5; 25; -3368 
1; 1131; 3396; 5; 30; -3366 
1; 1132; 3399; 5; 35; -3364 
1; 1133; 3402; 5; 15; -3387 
1; 1134; 3405; 5; 20; -3385 
1; 1135; 3408; 5; 25; -3383 
1; 1136; 3411; 5; 30; -3381 
1; 1137; 3414; 5; 35; -3379 
1; 1138; 3417; 5; 15; -3402 
1; 1139; 3420; 5; 20; -3400 
1; 1140; 3423; 5; 25; -3398 
1; 1141; 3426; 5; 30; -3396 
1; 1142; 3429; 5; 35; -3394 
1; 1143; 3432; 5; 15; -3417 
1; 1144; 3435; 5; 20; -3415 
1; 1145; 3438; 5; 25; -3413 
1; 1146; 3441; 5; 30; -3411 
1; 1147; 3444; 5; 35; -3409 
1; 1148; 3447; 5; 15; -3432 
1; 1149; 3450; 5; 20; -3430 
1; 1150; 3453; 5; 25; -3428 
1; 1151; 3456; 5; 30; -3426 
1; 1152; 3459; 5; 35; -3424 
1; 1153; 3462; 5; 15; -3447 
1; 1154; 3465; 5; 20; -3445 
1; 1155; 3468; 5; 25; -3443 
1; 1156; 3471; 5; 30; -3441 
1; 1157; 3474; 5; 35; -3439 
1; 1158; 3477; 5; 15; -3462 
1; 1159; 3480; 5; 20; -3460 
1; 1160; 3483; 5; 25; -3458 
1; 1161; 3486; 5; 30; -3456 
1; 1162; 3489; 5; 35; -3454 
1; 1163; 3492; 5; 15; -3477 
1; 1164; 3495; 5; 20; -3475 
1; 1165; 3498; 5; 25; -3473 
1; 1166; 3501; 5; 30; -3471 
1; 1167; 3504; 5; 35; -3469 
1; 1168; 3507; 5; 15; -3492 
1; 1169; 3510; 5; 20; -3490 
1; 1170; 3513; 5; 25; -3488 
1; 1171; 3516; 5; 30; -3486 
1; 1172; 3519; 5; 35; -3484 
1; 1173; 3522; 5; 15; -3507 
1; 1174; 3525; 5; 20; -3505 
1; 1175; 3528; 5; 25; -3503 
1; 1176; 3531; 5; 30; -3501 
1; 1177; 3534; 5; 35; -3499 
1; 1178; 3537; 5; 15; -3522 
1; 1179; 3540; 5; 20; -3520 
1; 1180; 3543; 5; 25; -3518 
1; 1181; 3546; 5; 30; -3516 
1; 1182; 3549; 5; 35; -3514 
1; 1183; 3552; 5; 15; -3537 
1; 1184; 3555; 5; 20; -3535 
1; 1185; 3558; 5; 25; -3533 
1; 1186; 3561; 5; 30; -3531 
1; 1187; 3564; 5; 35; -3529 
1; 1188; 3567; 5; 15; -3552 
1; 1189; 3570; 5; 20; -3550 
1; 1190; 3573; 5; 25; -3548 
1; 1191; 3576; 5; 30; -3546 
1; 1192; 3579; 5; 35; -3544 
1; 1193; 3582; 5; 15; -3567 
1; 1194; 3585; 5; 20; -3565 
1; 1195; 3588; 5; 25; -3563 
1; 1196; 3591; 5; 30; -3561 
1; 1197; 3594; 5; 35; -3559 
1; 1198; 3597; 5; 15; -3582 
1; 1199; 3600; 5; 20; -3580 
1; 1200; 3603; 5; 25; -3578 
1; 1201; 3606; 5; 30; -3576 
1; 1202; 3609; 5; 35; -3574 
1; 1203; 3612; 5; 15; -3597 
1; 1204; 3615; 5; 20; -3595 
1; 1205; 3618; 5; 25; -3593 
1; 1206; 3621; 5; 30; -3591 
1; 1207; 3624; 5; 35; -3589 
1; 1208; 3627; 5; 15; -3612 
1; 1209; 3630; 5; 20; -3610 
1; 1210; 3633; 5; 25; -3608 
1; 1211; 3636; 5; 30; -3606 
1; 1212; 3639; 5; 35; -3604 
1; 1213; 3642; 5; 15; -3627 
1; 1214; 3645; 5; 20; -3625 
1; 1215; 3648; 5; 25; -3623 
1; 1216; 3651; 5; 30; -3621 
1; 1217; 3654; 5; 35; -3619 
1; 1218; 3657; 5; 15; -3642 
1; 1219; 3660; 5; 20; -3640 
1; 1220; 3663; 5; 25; -3638 
1; 1221; 3666; 5; 30; -3636 
1; 1222; 3669; 5; 35; -3634 
1; 1223; 3672; 5; 15; -3657 
1; 1224; 3675; 5; 20; -3655 
1; 1225; 3678; 5; 25; -3653 
1; 1226; 3681; 5; 30; -3651 
1; 1227; 3684; 5; 35; -3649 
1; 1228; 3687; 5; 15; -3672 
1; 1229; 3690; 5; 20; -3670 
1; 1230; 3693; 5; 25; -3668 
1; 1231; 3696; 5; 30; -3666 
1; 1232; 3699; 5; 35; -3664 
1; 1233; 3702; 5; 15; -3687 
1; 1234; 3705; 5; 20; -3685 
1; 1235; 3708; 5; 25; -3683 
1; 1236; 3711; 5; 30; -3681 
1; 1237; 3714; 5; 35; -3679 
1; 1238; 3717; 5; 15; -3702 
1; 1239; 3720; 5; 20; -3700 
1; 1240; 3723; 5; 25; -3698 
1; 1241; 3726; 5; 30; -3696 
1; 1242; 3729; 5; 35; -3694 
1; 1243; 3732; 5; 15; -3717 
1; 1244; 3735; 5; 20; -3715 
1; 1245; 3738; 5; 25; -3713 
1; 1246; 3741; 5; 30; -3711 
1; 1247; 3744; 5; 35; -3709 
1; 1248; 3747; 5; 15; -3732 
1; 1249; 3750; 5; 20; -3730 
1; 1250; 3753; 5; 25; -3728 
1; 1251; 3756; 5; 30; -3726 
1; 1252; 3759; 5; 35; -3724 
1; 1253; 3762; 5; 15; -3747 
1; 1254; 3765; 5; 20; -3745 
1; 1255; 3768; 5; 25; -3743 
1; 1256; 3771; 5; 30; -3741 
1; 1257; 3774; 5; 35; -3739 
1; 1258; 3777; 5; 15; -3762 
1; 1259; 3780; 5; 20; -3760 
1; 1260; 3783; 5; 25; -3758 
1; 1261; 3786; 5; 30; -3756 
1; 1262; 3789; 5; 35; -3754 
1; 1263; 3792; 5; 15; -3777 
1; 1264; 3795; 5; 20; -3775 
1; 1265; 3798; 5; 25; -3773 
1; 1266; 3801; 5; 30; -3771 
1; 1267; 3804; 5; 35; -3769 
1; 1268; 3807; 5; 15; -3792 
1; 1269; 3810; 5; 20; -3790 
1; 1270; 3813; 5; 25; -3788 
1; 1271; 3816; 5; 30; -3786 
1; 1272; 3819; 5; 35; -3784 
1; 1273; 3822; 5; 15; -3807 
1; 1274; 3825; 5; 20; -3805 
1; 1275; 3828; 5; 25; -3803 
1; 1276; 3831; 5; 30; -3801 
1; 1277; 3834; 5; 35; -3799 
1; 1278; 3837; 5; 15; -3822 
1; 1279; 3840; 5; 20; -3820 
1; 1280; 3843; 5; 25; -3818 
1; 1281; 3846; 5; 30; -3816 
1; 1282; 3849; 5; 35; -3814 
1; 1283; 3852; 5; 15; -3837 
1; 1284; 3855; 5; 20; -3835 
1; 1285; 3858; 5; 25; -3833 
1; 1286; 3861; 5; 30; -3831 
1; 1287; 3864; 5; 35; -3829 
1; 1288; 3867; 5; 15; -3852 
1; 1289; 3870; 5; 20; -3850 
1; 1290; 3873; 5; 25; -3848 
1; 1291; 3876; 5; 30; -3846 
1; 1292; 3879; 5; 35; -3844 
1; 1293; 3882; 5; 15; -3867 
1; 1294; 3885; 5; 20; -3865 
1; 1295; 3888; 5; 25; -3863 
1; 1296; 3891; 5; 30; -3861 
1; 1297; 3894; 5; 35; -3859 
1; 1298; 3897; 5; 15; -3882 
1; 1299; 3900; 5; 20; -3880 
1; 1300; 3903; 5; 25; -3878 
1; 1301; 3906; 5; 30; -3876 
1; 1302; 3909; 5; 35; -3874 
1; 1303; 3912; 5; 15; -3897 
1; 1304; 3915; 5; 20; -3895 
1; 1305; 3918; 5; 25; -3893 
1; 1306; 3921; 5; 30; -3891 
1; 1307; 3924; 5; 35; -3889 
1; 1308; 3927; 5; 15; -3912 
1; 1309; 3930; 5; 20; -3910 
1; 1310; 3933; 5; 25; -3908 
1; 1311; 3936; 5; 30; -3906 
1; 1312; 3939; 5; 35; -3904 
1; 1313; 3942; 5; 15; -3927 
1; 1314; 3945; 5; 20; -3925 
1; 1315; 3948; 5; 25; -3923 
1; 1316; 3951; 5; 30; -3921 
1; 1317; 3954; 5; 35; -3919 
1; 1318; 3957; 5; 15; -3942 
1; 1319; 3960; 5; 20; -3940 
1; 1320; 3963; 5; 25; -3938 
1; 1321; 3966; 5; 30; -3936 
1; 1322; 3969; 5; 35; -3934 
1; 1323; 3972; 5; 15; -3957 
1; 1324; 3975; 5; 20; -3955 
1; 1325; 3978; 5; 25; -3953 
1; 1326; 3981; 5; 30; -3951 
1; 1327; 3984; 5; 35; -3949 
1; 1328; 3987; 5; 15; -3972 
1; 1329; 3990; 5; 20; -3970 
1; 1330; 3993; 5; 25; -3968 
1; 1331; 3996; 5; 30; -3966 
1; 1332; 3999; 5; 35; -3964 
1; 1333; 4002; 5; 15; -3987 
1; 1334; 4005; 5; 20; -3985 
1; 1335; 4008; 5; 25; -3983 
1; 1336; 4011; 5; 30; -3981 
1; 1337; 4014; 5; 35; -3979 
1; 1338; 4017; 5; 15; -4002 
1; 1339; 4020; 5; 20; -4000 
1; 1340; 4023; 5; 25; -3998 
1; 1341; 4026; 5; 30; -3996 
1; 1342; 4029; 5; 35; -3994 
1; 1343; 4032; 5; 15; -4017 
1; 1344; 4035; 5; 20; -4015 
1; 1345; 4038; 5; 25; -4013 
1; 1346; 4041; 5; 30; -4011 
1; 1347; 4044; 5; 35; -4009 
1; 1348; 4047; 5; 15; -4032 
1; 1349; 4050; 5; 20; -4030 
1; 1350; 4053; 5; 25; -4028 
1; 1351; 4056; 5; 30; -4026 
1; 1352; 4059; 5; 35; -4024 
1; 1353; 4062; 5; 15; -4047 
1; 1354; 4065; 5; 20; -4045 
1; 1355; 4068; 5; 25; -4043 
1; 1356; 4071; 5; 30; -4041 
1; 1357; 4074; 5; 35; -4039 
1; 1358; 4077; 5; 15; -4062 
1; 1359; 4080; 5; 20; -4060 
1; 1360; 4083; 5; 25; -4058 
1; 1361; 4086; 5; 30; -4056 
1; 1362; 4089; 5; 35; -4054 
1; 1363; 4092; 5; 15; -4077 
1; 1364; 4095; 5; 20; -4075 
1; 1365; 4098; 5; 25; -4073 
1; 1366; 4101; 5; 30; -4071 
1; 1367; 4104; 5; 35; -4069 
1; 1368; 4107; 5; 15; -4092 
1; 1369; 4110; 5; 20; -4090 
1; 1370; 4113; 5; 25; -4088 
1; 1371; 4116; 5; 30; -4086 
1; 1372; 4119; 5; 35; -4084 
1; 1373; 4122; 5; 15; -4107 
1; 1374; 4125; 5; 20; -4105 
1; 1375; 4128; 5; 25; -4103 
1; 1376; 4131; 5; 30; -4101 
1; 1377; 4134; 5; 35; -4099 
1; 1378; 4137; 5; 15; -4122 
1; 1379; 4140; 5; 20; -4120 
1; 1380; 4143; 5; 25; -4118 
1; 1381; 4146; 5; 30; -4116 
1; 1382; 4149; 5; 35; -4114 
1; 1383; 4152; 5; 15; -4137 
1; 1384; 4155; 5; 20; -4135 
1; 1385; 4158; 5; 25; -4133 
1; 1386; 4161; 5; 30; -4131 
1; 1387; 4164; 5; 35; -4129 
1; 1388; 4167; 5; 15; -4152 
1; 1389; 4170; 5; 20; -4150 
1; 1390; 4173; 5; 25; -4148 
1; 1391; 4176; 5; 30; -4146 
1; 1392; 4179; 5; 35; -4144 
1; 1393; 4182; 5; 15; -4167 
1; 1394; 4185; 5; 20; -4165 
1; 1395; 4188; 5; 25; -4163 
1; 1396; 4191; 5; 30; -4161 
1; 1397; 4194; 5; 35; -4159 
1; 1398; 4197; 5; 15; -4182 
1; 1399; 4200; 5; 20; -4180 
1; 1400; 4203; 5; 25; -4178 
1; 1401; 4206; 5; 30; -4176 
1; 1402; 4209; 5; 35; -4174 
1; 1403; 4212; 5; 15; -4197 
1; 1404; 4215; 5; 20; -4195 
1; 1405; 4218; 5; 25; -4193 
1; 1406; 4221; 5; 30; -4191 
1; 1407; 4224; 5; 35; -4189 
1; 1408; 4227; 5; 15; -4212 
1; 1409; 4230; 5; 20; -4210 
1; 1410; 4233; 5; 25; -4208 
1; 1411; 4236; 5; 30; -4206 
1; 1412; 4239; 5; 35; -4204 
1; 1413; 4242; 5; 15; -4227 
1; 1414; 4245; 5; 20; -4225 
1; 1415; 4248; 5; 25; -4223 
1; 1416; 4251; 5; 30; -4221 
1; 1417; 4254; 5; 35; -4219 
1; 1418; 4257; 5; 15; -4242 
1; 1419; 4260; 5; 20; -4240 
1; 1420; 4263; 5; 25; -4238 
1; 1421; 4266; 5; 30; -4236 
1; 1422; 4269; 5; 35; -4234 
1; 1423; 4272; 5; 15; -4257 
1; 1424; 4275; 5; 20; -4255 
1; 1425; 4278; 5; 25; -4253 
1; 1426; 4281; 5; 30; -4251 
1; 1427; 4284; 5; 35; -4249 
1; 1428; 4287; 5; 15; -4272 
1; 1429; 4290; 5; 20; -4270 
1; 1430; 4293; 5; 25; -4268 
1; 1431; 4296; 5; 30; -4266 
1; 1432; 4299; 5; 35; -4264 
1; 1433; 4302; 5; 15; -4287 
1; 1434; 4305; 5; 20; -4285 
1; 1435; 4308; 5; 25; -4283 
1; 1436; 4311; 5; 30; -4281 
1; 1437; 4314; 5; 35; -4279 
1; 1438; 4317; 5; 15; -4302 
1; 1439; 4320; 5; 20; -4300 
1; 1440; 4323; 5; 25; -4298 
1; 1441; 4326; 5; 30; -4296 
1; 1442; 4329; 5; 35; -4294 
1; 1443; 4332; 5; 15; -4317 
1; 1444; 4335; 5; 20; -4315 
1; 1445; 4338; 5; 25; -4313 
1; 1446; 4341; 5; 30; -4311 
1; 1447; 4344; 5; 35; -4309 
1; 1448; 4347; 5; 15; -4332 
1; 1449; 4350; 5; 20; -4330 
1; 1450; 4353; 5; 25; -4328 
1; 1451; 4356; 5; 30; -4326 
1; 1452; 4359; 5; 35; -4324 
1; 1453; 4362; 5; 15; -4347 
1; 1454; 4365; 5; 20; -4345 
1; 1455; 4368; 5; 25; -4343 
1; 1456; 4371; 5; 30; -4341 
1; 1457; 4374; 5; 35; -4339 
1; 1458; 4377; 5; 15; -4362 
1; 1459; 4380; 5; 20; -4360 
1; 1460; 4383; 5; 25; -4358 
1; 1461; 4386; 5; 30; -4356 
1; 1462; 4389; 5; 35; -4354 
1; 1463; 4392; 5; 15; -4377 
1; 1464; 4395; 5; 20; -4375 
1; 1465; 4398; 5; 25; -4373 
1; 1466; 4401; 5; 30; -4371 
1; 1467; 4404; 5; 35; -4369 
1; 1468; 4407; 5; 15; -4392 
1; 1469; 4410; 5; 20; -4390 
1; 1470; 4413; 5; 25; -4388 
1; 1471; 4416; 5; 30; -4386 
1; 1472; 4419; 5; 35; -4384 
1; 1473; 4422; 5; 15; -4407 
1; 1474; 4425; 5; 20; -4405 
1; 1475; 4428; 5; 25; -4403 
1; 1476; 4431; 5; 30; -4401 
1; 1477; 4434; 5; 35; -4399 
1; 1478; 4437; 5; 15; -4422 
1; 1479; 4440; 5; 20; -4420 
1; 1480; 4443; 5; 25; -4418 
1; 1481; 4446; 5; 30; -4416 
1; 1482; 4449; 5; 35; -4414 
1; 1483; 4452; 5; 15; -4437 
1; 1484; 4455; 5; 20; -4435 
1; 1485; 4458; 5; 25; -4433 
1; 1486; 4461; 5; 30; -4431 
1; 1487; 4464; 5; 35; -4429 
1; 1488; 4467; 5; 15; -4452 
1; 1489; 4470; 5; 20; -4450 
1; 1490; 4473; 5; 25; -4448 
1; 1491; 4476; 5; 30; -4446 
1; 1492; 4479; 5; 35; -4444 
1; 1493; 4482; 5; 15; -4467 
1; 1494; 4485; 5; 20; -4465 
1; 1495; 4488; 5; 25; -4463 
1; 1496; 4491; 5; 30; -4461 
1; 1497; 4494; 5; 35; -4459 
1; 1498; 4497; 5; 15; -4482 
1; 1499; 4500; 5; 20; -4480 
1; 1500; 4503; 5; 25; -4478 
1; 1501; 4506; 5; 30; -4476 
1; 1502; 4509; 5; 35; -4474 
1; 1503; 4512; 5; 15; -4497 
1; 1504; 4515; 5; 20; -4495 
1; 1505; 4518; 5; 25; -4493 
1; 1506; 4521; 5; 30; -4491 
1; 1507; 4524; 5; 35; -4489 
1; 1508; 4527; 5; 15; -4512 
1; 1509; 4530; 5; 20; -4510 
1; 1510; 4533; 5; 25; -4508 
1; 1511; 4536; 5; 30; -4506 
1; 1512; 4539; 5; 35; -4504 
1; 1513; 4542; 5; 15; -4527 
1; 1514; 4545; 5; 20; -4525 
1; 1515; 4548; 5; 25; -4523 
1; 1516; 4551; 5; 30; -4521 
1; 1517; 4554; 5; 35; -4519 
1; 1518; 4557; 5; 15; -4542 
1; 1519; 4560; 5; 20; -4540 
1; 1520; 4563; 5; 25; -4538 
1; 1521; 4566; 5; 30; -4536 
1; 1522; 4569; 5; 35; -4534 
1; 1523; 4572; 5; 15; -4557 
1; 1524; 4575; 5; 20; -4555 
1; 1525; 4578; 5; 25; -4553 
1; 1526; 4581; 5; 30; -4551 
1; 1527; 4584; 5; 35; -4549 
1; 1528; 4587; 5; 15; -4572 
1; 1529; 4590; 5; 20; -4570 
1; 1530; 4593; 5; 25; -4568 
1; 1531; 4596; 5; 30; -4566 
1; 1532; 4599; 5; 35; -4564 
1; 1533; 4602; 5; 15; -4587 
1; 1534; 4605; 5; 20; -4585 
1; 1535; 4608; 5; 25; -4583 
1; 1536; 4611; 5; 30; -4581 
1; 1537; 4614; 5; 35; -4579 
1; 1538; 4617; 5; 15; -4602 
1; 1539; 4620; 5; 20; -4600 
1; 1540; 4623; 5; 25; -4598 
1; 1541; 4626; 5; 30; -4596 
1; 1542; 4629; 5; 35; -4594 
1; 1543; 4632; 5; 15; -4617 
1; 1544; 4635; 5; 20; -4615 
1; 1545; 4638; 5; 25; -4613 
1; 1546; 4641; 5; 30; -4611 
1; 1547; 4644; 5; 35; -4609 
1; 1548; 4647; 5; 15; -4632 
1; 1549; 4650; 5; 20; -4630 
1; 1550; 4653; 5; 25; -4628 
1; 1551; 4656; 5; 30; -4626 
1; 1552; 4659; 5; 35; -4624 
1; 1553; 4662; 5; 15; -4647 
1; 1554; 4665; 5; 20; -4645 
1; 1555; 4668; 5; 25; -4643 
1; 1556; 4671; 5; 30; -4641 
1; 1557; 4674; 5; 35; -4639 
1; 1558; 4677; 5; 15; -4662 
1; 1559; 4680; 5; 20; -4660 
1; 1560; 4683; 5; 25; -4658 
1; 1561; 4686; 5; 30; -4656 
1; 1562; 4689; 5; 35; -4654 
1; 1563; 4692; 5; 15; -4677 
1; 1564; 4695; 5; 20; -4675 
1; 1565; 4698; 5; 25; -4673 
1; 1566; 4701; 5; 30; -4671 
1; 1567; 4704; 5; 35; -4669 
1; 1568; 4707; 5; 15; -4692 
1; 1569; 4710; 5; 20; -4690 
1; 1570; 4713; 5; 25; -4688 
1; 1571; 4716; 5; 30; -4686 
1; 1572; 4719; 5; 35; -4684 
1; 1573; 4722; 5; 15; -4707 
1; 1574; 4725; 5; 20; -4705 
1; 1575; 4728; 5; 25; -4703 
1; 1576; 4731; 5; 30; -4701 
1; 1577; 4734; 5; 35; -4699 
1; 1578; 4737; 5; 15; -4722 
1; 1579; 4740; 5; 20; -4720 
1; 1580; 4743; 5; 25; -4718 
1; 1581; 4746; 5; 30; -4716 
1; 1582; 4749; 5; 35; -4714 
1; 1583; 4752; 5; 15; -4737 
1; 1584; 4755; 5; 20; -4735 
1; 1585; 4758; 5; 25; -4733 
1; 1586; 4761; 5; 30; -4731 
1; 1587; 4764; 5; 35; -4729 
1; 1588; 4767; 5; 15; -4752 
1; 1589; 4770; 5; 20; -4750 
1; 1590; 4773; 5; 25; -4748 
1; 1591; 4776; 5; 30; -4746 
1; 1592; 4779; 5; 35; -4744 
1; 1593; 4782; 5; 15; -4767 
1; 1594; 4785; 5; 20; -4765 
1; 1595; 4788; 5; 25; -4763 
1; 1596; 4791; 5; 30; -4761 
1; 1597; 4794; 5; 35; -4759 
1; 1598; 4797; 5; 15; -4782 
1; 1599; 4800; 5; 20; -4780 
1; 1600; 4803; 5; 25; -4778 
1; 1601; 4806; 5; 30; -4776 
1; 1602; 4809; 5; 35; -4774 
1; 1603; 4812; 5; 15; -4797 
1; 1604; 4815; 5; 20; -4795 
1; 1605; 4818; 5; 25; -4793 
1; 1606; 4821; 5; 30; -4791 
1; 1607; 4824; 5; 35; -4789 
1; 1608; 4827; 5; 15; -4812 
1; 1609; 4830; 5; 20; -4810 
1; 1610; 4833; 5; 25; -4808 
1; 1611; 4836; 5; 30; -4806 
1; 1612; 4839; 5; 35; -4804 
1; 1613; 4842; 5; 15; -4827 
1; 1614; 4845; 5; 20; -4825 
1; 1615; 4848; 5; 25; -4823 
1; 1616; 4851; 5; 30; -4821 
1; 1617; 4854; 5; 35; -4819 
1; 1618; 4857; 5; 15; -4842 
1; 1619; 4860; 5; 20; -4840 
1; 1620; 4863; 5; 25; -4838 
1; 1621; 4866; 5; 30; -4836 
1; 1622; 4869; 5; 35; -4834 
1; 1623; 4872; 5; 15; -4857 
1; 1624; 4875; 5; 20; -4855 
1; 1625; 4878; 5; 25; -4853 
1; 1626; 4881; 5; 30; -4851 
1; 1627; 4884; 5; 35; -4849 
1; 1628; 4887; 5; 15; -4872 
1; 1629; 4890; 5; 20; -4870 
1; 1630; 4893; 5; 25; -4868 
1; 1631; 4896; 5; 30; -4866 
1; 1632; 4899; 5; 35; -4864 
1; 1633; 4902; 5; 15; -4887 
1; 1634; 4905; 5; 20; -4885 
1; 1635; 4908; 5; 25; -4883 
1; 1636; 4911; 5; 30; -4881 
1; 1637; 4914; 5; 35; -4879 
1; 1638; 4917; 5; 15; -4902 
1; 1639; 4920; 5; 20; -4900 
1; 1640; 4923; 5; 25; -4898 
1; 1641; 4926; 5; 30; -4896 
1; 1642; 4929; 5; 35; -4894 
1; 1643; 4932; 5; 15; -4917 
1; 1644; 4935; 5; 20; -4915 
1; 1645; 4938; 5; 25; -4913 
1; 1646; 4941; 5; 30; -4911 
1; 1647; 4944; 5; 35; -4909 
1; 1648; 4947; 5; 15; -4932 
1; 1649; 4950; 5; 20; -4930 
1; 1650; 4953; 5; 25; -4928 
1; 1651; 4956; 5; 30; -4926 
1; 1652; 4959; 5; 35; -4924 
1; 1653; 4962; 5; 15; -4947 
1; 1654; 4965; 5; 20; -4945 
1; 1655; 4968; 5; 25; -4943 
1; 1656; 4971; 5; 30; -4941 
1; 1657; 4974; 5; 35; -4939 
1; 1658; 4977; 5; 15; -4962 
1; 1659; 4980; 5; 20; -4960 
1; 1660; 4983; 5; 25; -4958 
1; 1661; 4986; 5; 30; -4956 
1; 1662; 4989; 5; 35; -4954 
1; 1663; 4992; 5; 15; -4977 
1; 1664; 4995; 5; 20; -4975 
1; 1665; 4998; 5; 25; -4973 
1; 1666; 5001; 5; 30; -4971 
1; 1667; 5004; 5; 35; -4969 
1; 1668; 5007; 5; 15; -4992 
1; 1669; 5010; 5; 20; -4990 
1; 1670; 5013; 5; 25; -4988 
1; 1671; 5016; 5; 30; -4986 
1; 1672; 5019; 5; 35; -4984 
1; 1673; 5022; 5; 15; -5007 
1; 1674; 5025; 5; 20; -5005 
1; 1675; 5028; 5; 25; -5003 
1; 1676; 5031; 5; 30; -5001 
1; 1677; 5034; 5; 35; -4999 
1; 1678; 5037; 5; 15; -5022 
1; 1679; 5040; 5; 20; -5020 
1; 1680; 5043; 5; 25; -5018 
1; 1681; 5046; 5; 30; -5016 
1; 1682; 5049; 5; 35; -5014 
1; 1683; 5052; 5; 15; -5037 
1; 1684; 5055; 5; 20; -5035 
1; 1685; 5058; 5; 25; -5033 
1; 1686; 5061; 5; 30; -5031 
1; 1687; 5064; 5; 35; -5029 
1; 1688; 5067; 5; 15; -5052 
1; 1689; 5070; 5; 20; -5050 
1; 1690; 5073; 5; 25; -5048 
1; 1691; 5076; 5; 30; -5046 
1; 1692; 5079; 5; 35; -5044 
1; 1693; 5082; 5; 15; -5067 
1; 1694; 5085; 5; 20; -5065 
1; 1695; 5088; 5; 25; -5063 
1; 1696; 5091; 5; 30; -5061 
1; 1697; 5094; 5; 35; -5059 
1; 1698; 5097; 5; 15; -5082 
1; 1699; 5100; 5; 20; -5080 
1; 1700; 5103; 5; 25; -5078 
1; 1701; 5106; 5; 30; -5076 
1; 1702; 5109; 5; 35; -5074 
1; 1703; 5112; 5; 15; -5097 
1; 1704; 5115; 5; 20; -5095 
1; 1705; 5118; 5; 25; -5093 
1; 1706; 5121; 5; 30; -5091 
1; 1707; 5124; 5; 35; -5089 
1; 1708; 5127; 5; 15; -5112 
1; 1709; 5130; 5; 20; -5110 
1; 1710; 5133; 5; 25; -5108 
1; 1711; 5136; 5; 30; -5106 
1; 1712; 5139; 5; 35; -5104 
1; 1713; 5142; 5; 15; -5127 
1; 1714; 5145; 5; 20; -5125 
1; 1715; 5148; 5; 25; -5123 
1; 1716; 5151; 5; 30; -5121 
1; 1717; 5154; 5; 35; -5119 
1; 1718; 5157; 5; 15; -5142 
1; 1719; 5160; 5; 20; -5140 
1; 1720; 5163; 5; 25; -5138 
1; 1721; 5166; 5; 30; -5136 
1; 1722; 5169; 5; 35; -5134 
1; 1723; 5172; 5; 15; -5157 
1; 1724; 5175; 5; 20; -5155 
1; 1725; 5178; 5; 25; -5153 
1; 1726; 5181; 5; 30; -5151 
1; 1727; 5184; 5; 35; -5149 
1; 1728; 5187; 5; 15; -5172 
1; 1729; 5190; 5; 20; -5170 
1; 1730; 5193; 5; 25; -5168 
1; 1731; 5196; 5; 30; -5166 
1; 1732; 5199; 5; 35; -5164 
1; 1733; 5202; 5; 15; -5187 
1; 1734; 5205; 5; 20; -5185 
1; 1735; 5208; 5; 25; -5183 
1; 1736; 5211; 5; 30; -5181 
1; 1737; 5214; 5; 35; -5179 
1; 1738; 5217; 5; 15; -5202 
1; 1739; 5220; 5; 20; -5200 
1; 1740; 5223; 5; 25; -5198 
1; 1741; 5226; 5; 30; -5196 
1; 1742; 5229; 5; 35; -5194 
1; 1743; 5232; 5; 15; -5217 
1; 1744; 5235; 5; 20; -5215 
1; 1745; 5238; 5; 25; -5213 
1; 1746; 5241; 5; 30; -5211 
1; 1747; 5244; 5; 35; -5209 
1; 1748; 5247; 5; 15; -5232 
1; 1749; 5250; 5; 20; -5230 
1; 1750; 5253; 5; 25; -5228 
1; 1751; 5256; 5; 30; -5226 
1; 1752; 5259; 5; 35; -5224 
1; 1753; 5262; 5; 15; -5247 
1; 1754; 5265; 5; 20; -5245 
1; 1755; 5268; 5; 25; -5243 
1; 1756; 5271; 5; 30; -5241 
1; 1757; 5274; 5; 35; -5239 
1; 1758; 5277; 5; 15; -5262 
1; 1759; 5280; 5; 20; -5260 
1; 1760; 5283; 5; 25; -5258 
1; 1761; 5286; 5; 30; -5256 
1; 1762; 5289; 5; 35; -5254 
1; 1763; 5292; 5; 15; -5277 
1; 1764; 5295; 5; 20; -5275 
1; 1765; 5298; 5; 25; -5273 
1; 1766; 5301; 5; 30; -5271 
1; 1767; 5304; 5; 35; -5269 
1; 1768; 5307; 5; 15; -5292 
1; 1769; 5310; 5; 20; -5290 
1; 1770; 5313; 5; 25; -5288 
1; 1771; 5316; 5; 30; -5286 
1; 1772; 5319; 5; 35; -5284 
1; 1773; 5322; 5; 15; -5307 
1; 1774; 5325; 5; 20; -5305 
1; 1775; 5328; 5; 25; -5303 
1; 1776; 5331; 5; 30; -5301 
1; 1777; 5334; 5; 35; -5299 
1; 1778; 5337; 5; 15; -5322 
1; 1779; 5340; 5; 20; -5320 
1; 1780; 5343; 5; 25; -5318 
1; 1781; 5346; 5; 30; -5316 
1; 1782; 5349; 5; 35; -5314 
1; 1783; 5352; 5; 15; -5337 
1; 1784; 5355; 5; 20; -5335 
1; 1785; 5358; 5; 25; -5333 
1; 1786; 5361; 5; 30; -5331 
1; 1787; 5364; 5; 35; -5329 
1; 1788; 5367; 5; 15; -5352 
1; 1789; 5370; 5; 20; -5350 
1; 1790; 5373; 5; 25; -5348 
1; 1791; 5376; 5; 30; -5346 
1; 1792; 5379; 5; 35; -5344 
1; 1793; 5382; 5; 15; -5367 
1; 1794; 5385; 5; 20; -5365 
1; 1795; 5388; 5; 25; -5363 
1; 1796; 5391; 5; 30; -5361 
1; 1797; 5394; 5; 35; -5359 
1; 1798; 5397; 5; 15; -5382 
1; 1799; 5400; 5; 20; -5380 
1; 1800; 5403; 5; 25; -5378 
1; 1801; 5406; 5; 30; -5376 
1; 1802; 5409; 5; 35; -5374 
1; 1803; 5412; 5; 15; -5397 
1; 1804; 5415; 5; 20; -5395 
1; 1805; 5418; 5; 25; -5393 
1; 1806; 5421; 5; 30; -5391 
1; 1807; 5424; 5; 35; -5389 
1; 1808; 5427; 5; 15; -5412 
1; 1809; 5430; 5; 20; -5410 
1; 1810; 5433; 5; 25; -5408 
1; 1811; 5436; 5; 30; -5406 
1; 1812; 5439; 5; 35; -5404 
1; 1813; 5442; 5; 15; -5427 
1; 1814; 5445; 5; 20; -5425 
1; 1815; 5448; 5; 25; -5423 
1; 1816; 5451; 5; 30; -5421 
1; 1817; 5454; 5; 35; -5419 
1; 1818; 5457; 5; 15; -5442 
1; 1819; 5460; 5; 20; -5440 
1; 1820; 5463; 5; 25; -5438 
1; 1821; 5466; 5; 30; -5436 
1; 1822; 5469; 5; 35; -5434 
1; 1823; 5472; 5; 15; -5457 
1; 1824; 5475; 5; 20; -5455 
1; 1825; 5478; 5; 25; -5453 
1; 1826; 5481; 5; 30; -5451 
1; 1827; 5484; 5; 35; -5449 
1; 1828; 5487; 5; 15; -5472 
1; 1829; 5490; 5; 20; -5470 
1; 1830; 5493; 5; 25; -5468 
1; 1831; 5496; 5; 30; -5466 
1; 1832; 5499; 5; 35; -5464 
1; 1833; 5502; 5; 15; -5487 
1; 1834; 5505; 5; 20; -5485 
1; 1835; 5508; 5; 25; -5483 
1; 1836; 5511; 5; 30; -5481 
1; 1837; 5514; 5; 35; -5479 
1; 1838; 5517; 5; 15; -5502 
1; 1839; 5520; 5; 20; -5500 
1; 1840; 5523; 5; 25; -5498 
1; 1841; 5526; 5; 30; -5496 
1; 1842; 5529; 5; 35; -5494 
1; 1843; 5532; 5; 15; -5517 
1; 1844; 5535; 5; 20; -5515 
1; 1845; 5538; 5; 25; -5513 
1; 1846; 5541; 5; 30; -5511 
1; 1847; 5544; 5; 35; -5509 
1; 1848; 5547; 5; 15; -5532 
1; 1849; 5550; 5; 20; -5530 
1; 1850; 5553; 5; 25; -5528 
1; 1851; 5556; 5; 30; -5526 
1; 1852; 5559; 5; 35; -5524 
1; 1853; 5562; 5; 15; -5547 
1; 1854; 5565; 5; 20; -5545 
1; 1855; 5568; 5; 25; -5543 
1; 1856; 5571; 5; 30; -5541 
1; 1857; 5574; 5; 35; -5539 
1; 1858; 5577; 5; 15; -5562 
1; 1859; 5580; 5; 20; -5560 
1; 1860; 5583; 5; 25; -5558 
1; 1861; 5586; 5; 30; -5556 
1; 1862; 5589; 5; 35; -5554 
1; 1863; 5592; 5; 15; -5577 
1; 1864; 5595; 5; 20; -5575 
1; 1865; 5598; 5; 25; -5573 
1; 1866; 5601; 5; 30; -5571 
1; 1867; 5604; 5; 35; -5569 
1; 1868; 5607; 5; 15; -5592 
1; 1869; 5610; 5; 20; -5590 
1; 1870; 5613; 5; 25; -5588 
1; 1871; 5616; 5; 30; -5586 
1; 1872; 5619; 5; 35; -5584 
1; 1873; 5622; 5; 15; -5607 
1; 1874; 5625; 5; 20; -5605 
1; 1875; 5628; 5; 25; -5603 
1; 1876; 5631; 5; 30; -5601 
1; 1877; 5634; 5; 35; -5599 
1; 1878; 5637; 5; 15; -5622 
1; 1879; 5640; 5; 20; -5620 
1; 1880; 5643; 5; 25; -5618 
1; 1881; 5646; 5; 30; -5616 
1; 1882; 5649; 5; 35; -5614 
1; 1883; 5652; 5; 15; -5637 
1; 1884; 5655; 5; 20; -5635 
1; 1885; 5658; 5; 25; -5633 
1; 1886; 5661; 5; 30; -5631 
1; 1887; 5664; 5; 35; -5629 
1; 1888; 5667; 5; 15; -5652 
1; 1889; 5670; 5; 20; -5650 
1; 1890; 5673; 5; 25; -5648 
1; 1891; 5676; 5; 30; -5646 
1; 1892; 5679; 5; 35; -5644 
1; 1893; 5682; 5; 15; -5667 
1; 1894; 5685; 5; 20; -5665 
1; 1895; 5688; 5; 25; -5663 
1; 1896; 5691; 5; 30; -5661 
1; 1897; 5694; 5; 35; -5659 
1; 1898; 5697; 5; 15; -5682 
1; 1899; 5700; 5; 20; -5680 
1; 1900; 5703; 5; 25; -5678 
1; 1901; 5706; 5; 30; -5676 
1; 1902; 5709; 5; 35; -5674 
1; 1903; 5712; 5; 15; -5697 
1; 1904; 5715; 5; 20; -5695 
1; 1905; 5718; 5; 25; -5693 
1; 1906; 5721; 5; 30; -5691 
1; 1907; 5724; 5; 35; -5689 
1; 1908; 5727; 5; 15; -5712 
1; 1909; 5730; 5; 20; -5710 
1; 1910; 5733; 5; 25; -5708 
1; 1911; 5736; 5; 30; -5706 
1; 1912; 5739; 5; 35; -5704 
1; 1913; 5742; 5; 15; -5727 
1; 1914; 5745; 5; 20; -5725 
1; 1915; 5748; 5; 25; -5723 
1; 1916; 5751; 5; 30; -5721 
1; 1917; 5754; 5; 35; -5719 
1; 1918; 5757; 5; 15; -5742 
1; 1919; 5760; 5; 20; -5740 
1; 1920; 5763; 5; 25; -5738 
1; 1921; 5766; 5; 30; -5736 
1; 1922; 5769; 5; 35; -5734 
1; 1923; 5772; 5; 15; -5757 
1; 1924; 5775; 5; 20; -5755 
1; 1925; 5778; 5; 25; -5753 
1; 1926; 5781; 5; 30; -5751 
1; 1927; 5784; 5; 35; -5749 
1; 1928; 5787; 5; 15; -5772 
1; 1929; 5790; 5; 20; -5770 
1; 1930; 5793; 5; 25; -5768 
1; 1931; 5796; 5; 30; -5766 
1; 1932; 5799; 5; 35; -5764 
1; 1933; 5802; 5; 15; -5787 
1; 1934; 5805; 5; 20; -5785 
1; 1935; 5808; 5; 25; -5783 
1; 1936; 5811; 5; 30; -5781 
1; 1937; 5814; 5; 35; -5779 
1; 1938; 5817; 5; 15; -5802 
1; 1939; 5820; 5; 20; -5800 
1; 1940; 5823; 5; 25; -5798 
1; 1941; 5826; 5; 30; -5796 
1; 1942; 5829; 5; 35; -5794 
1; 1943; 5832; 5; 15; -5817 
1; 1944; 5835; 5; 20; -5815 
1; 1945; 5838; 5; 25; -5813 
1; 1946; 5841; 5; 30; -5811 
1; 1947; 5844; 5; 35; -5809 
1; 1948; 5847; 5; 15; -5832 
1; 1949; 5850; 5; 20; -5830 
1; 1950; 5853; 5; 25; -5828 
1; 1951; 5856; 5; 30; -5826 
1; 1952; 5859; 5; 35; -5824 
1; 1953; 5862; 5; 15; -5847 
1; 1954; 5865; 5; 20; -5845 
1; 1955; 5868; 5; 25; -5843 
1; 1956; 5871; 5; 30; -5841 
1; 1957; 5874; 5; 35; -5839 
1; 1958; 5877; 5; 15; -5862 
1; 1959; 5880; 5; 20; -5860 
1; 1960; 5883; 5; 25; -5858 
1; 1961; 5886; 5; 30; -5856 
1; 1962; 5889; 5; 35; -5854 
1; 1963; 5892; 5; 15; -5877 
1; 1964; 5895; 5; 20; -5875 
1; 1965; 5898; 5; 25; -5873 
1; 1966; 5901; 5; 30; -5871 
1; 1967; 5904; 5; 35; -5869 
1; 1968; 5907; 5; 15; -5892 
1; 1969; 5910; 5; 20; -5890 
1; 1970; 5913; 5; 25; -5888 
1; 1971; 5916; 5; 30; -5886 
1; 1972; 5919; 5; 35; -5884 
1; 1973; 5922; 5; 15; -5907 
1; 1974; 5925; 5; 20; -5905 
1; 1975; 5928; 5; 25; -5903 
1; 1976; 5931; 5; 30; -5901 
1; 1977; 5934; 5; 35; -5899 
1; 1978; 5937; 5; 15; -5922 
1; 1979; 5940; 5; 20; -5920 
1; 1980; 5943; 5; 25; -5918 
1; 1981; 5946; 5; 30; -5916 
1; 1982; 5949; 5; 35; -5914 
1; 1983; 5952; 5; 15; -5937 
1; 1984; 5955; 5; 20; -5935 
1; 1985; 5958; 5; 25; -5933 
1; 1986; 5961; 5; 30; -5931 
1; 1987; 5964; 5; 35; -5929 
1; 1988; 5967; 5; 15; -5952 
1; 1989; 5970; 5; 20; -5950 
1; 1990; 5973; 5; 25; -5948 
1; 1991; 5976; 5; 30; -5946 
1; 1992; 5979; 5; 35; -5944 
1; 1993; 5982; 5; 15; -5967 
1; 1994; 5985; 5; 20; -5965 
1; 1995; 5988; 5; 25; -5963 
1; 1996; 5991; 5; 30; -5961 
1; 1997; 5994; 5; 35; -5959 
1; 1998; 5997; 5; 15; -5982 
1; 1999; 6000; 5; 20; -5980 
1; 2000; 6003; 5; 25; -5978 
