Grupo; Processo; Inst. Chegada; Tempo de Servi√ßo; Inst. Atendimento; Tempo Perm. Fila 
Grupo 1 
1; 1; 6; 5; 8; 2 
1; 2; 9; 5; 13; 4 
1; 3; 12; 5; 18; 6 
1; 4; 15; 5; 23; 8 
1; 5; 18; 5; 28; 10 
1; 6; 21; 5; 33; 12 
1; 7; 24; 5; 38; 14 
1; 8; 27; 5; 55; 28 
1; 9; 30; 5; 60; 30 
1; 10; 33; 5; 65; 32 
1; 11; 36; 5; 70; 34 
1; 12; 39; 5; 75; 36 
1; 13; 42; 5; 80; 38 
1; 14; 45; 5; 85; 40 
1; 15; 48; 5; 90; 42 
1; 16; 51; 5; 95; 44 
1; 17; 54; 5; 100; 46 
1; 18; 57; 5; 105; 48 
1; 19; 60; 5; 110; 50 
1; 20; 63; 5; 115; 52 
1; 21; 66; 5; 120; 54 
1; 22; 69; 5; 125; 56 
1; 23; 72; 5; 130; 58 
1; 24; 75; 5; 135; 60 
1; 25; 78; 5; 140; 62 
1; 26; 81; 5; 145; 64 
1; 27; 84; 5; 150; 66 
1; 28; 87; 5; 155; 68 
1; 29; 90; 5; 160; 70 
1; 30; 93; 5; 165; 72 
1; 31; 96; 5; 170; 74 
1; 32; 99; 5; 175; 76 
1; 33; 102; 5; 180; 78 
1; 34; 105; 5; 185; 80 
1; 35; 108; 5; 190; 82 
1; 36; 111; 5; 195; 84 
1; 37; 114; 5; 200; 86 
1; 38; 117; 5; 205; 88 
1; 39; 120; 5; 210; 90 
1; 40; 123; 5; 215; 92 
1; 41; 126; 5; 220; 94 
1; 42; 129; 5; 225; 96 
1; 43; 132; 5; 230; 98 
1; 44; 135; 5; 235; 100 
1; 45; 138; 5; 240; 102 
1; 46; 141; 5; 245; 104 
1; 47; 144; 5; 250; 106 
1; 48; 147; 5; 255; 108 
1; 49; 150; 5; 260; 110 
1; 50; 153; 5; 265; 112 
1; 51; 156; 5; 270; 114 
1; 52; 159; 5; 275; 116 
1; 53; 162; 5; 280; 118 
1; 54; 165; 5; 285; 120 
1; 55; 168; 5; 290; 122 
1; 56; 171; 5; 295; 124 
1; 57; 174; 5; 300; 126 
1; 58; 177; 5; 305; 128 
1; 59; 180; 5; 310; 130 
1; 60; 183; 5; 315; 132 
1; 61; 186; 5; 320; 134 
1; 62; 189; 5; 325; 136 
1; 63; 192; 5; 330; 138 
1; 64; 195; 5; 335; 140 
1; 65; 198; 5; 340; 142 
1; 66; 201; 5; 345; 144 
1; 67; 204; 5; 350; 146 
1; 68; 207; 5; 355; 148 
1; 69; 210; 5; 360; 150 
1; 70; 213; 5; 365; 152 
1; 71; 216; 5; 370; 154 
1; 72; 219; 5; 375; 156 
1; 73; 222; 5; 380; 158 
1; 74; 225; 5; 385; 160 
1; 75; 228; 5; 390; 162 
1; 76; 231; 5; 395; 164 
1; 77; 234; 5; 400; 166 
1; 78; 237; 5; 405; 168 
1; 79; 240; 5; 410; 170 
1; 80; 243; 5; 415; 172 
1; 81; 246; 5; 420; 174 
1; 82; 249; 5; 425; 176 
1; 83; 252; 5; 430; 178 
1; 84; 255; 5; 435; 180 
1; 85; 258; 5; 440; 182 
1; 86; 261; 5; 445; 184 
1; 87; 264; 5; 450; 186 
1; 88; 267; 5; 455; 188 
1; 89; 270; 5; 460; 190 
1; 90; 273; 5; 465; 192 
1; 91; 276; 5; 470; 194 
1; 92; 279; 5; 475; 196 
1; 93; 282; 5; 480; 198 
1; 94; 285; 5; 485; 200 
1; 95; 288; 5; 490; 202 
1; 96; 291; 5; 495; 204 
1; 97; 294; 5; 500; 206 
1; 98; 297; 5; 505; 208 
1; 99; 300; 5; 510; 210 
1; 100; 303; 5; 515; 212 
1; 101; 306; 5; 520; 214 
1; 102; 309; 5; 525; 216 
1; 103; 312; 5; 530; 218 
1; 104; 315; 5; 535; 220 
1; 105; 318; 5; 540; 222 
1; 106; 321; 5; 545; 224 
1; 107; 324; 5; 550; 226 
1; 108; 327; 5; 555; 228 
1; 109; 330; 5; 560; 230 
1; 110; 333; 5; 565; 232 
1; 111; 336; 5; 570; 234 
1; 112; 339; 5; 575; 236 
1; 113; 342; 5; 580; 238 
1; 114; 345; 5; 585; 240 
1; 115; 348; 5; 590; 242 
1; 116; 351; 5; 595; 244 
1; 117; 354; 5; 600; 246 
1; 118; 357; 5; 605; 248 
1; 119; 360; 5; 610; 250 
1; 120; 363; 5; 615; 252 
1; 121; 366; 5; 620; 254 
1; 122; 369; 5; 625; 256 
1; 123; 372; 5; 630; 258 
1; 124; 375; 5; 635; 260 
1; 125; 378; 5; 640; 262 
1; 126; 381; 5; 645; 264 
1; 127; 384; 5; 650; 266 
1; 128; 387; 5; 655; 268 
1; 129; 390; 5; 660; 270 
1; 130; 393; 5; 665; 272 
1; 131; 396; 5; 670; 274 
1; 132; 399; 5; 675; 276 
1; 133; 402; 5; 680; 278 
1; 134; 405; 5; 685; 280 
1; 135; 408; 5; 690; 282 
1; 136; 411; 5; 695; 284 
1; 137; 414; 5; 700; 286 
1; 138; 417; 5; 705; 288 
1; 139; 420; 5; 710; 290 
1; 140; 423; 5; 715; 292 
1; 141; 426; 5; 720; 294 
1; 142; 429; 5; 725; 296 
1; 143; 432; 5; 730; 298 
1; 144; 435; 5; 735; 300 
1; 145; 438; 5; 740; 302 
1; 146; 441; 5; 745; 304 
1; 147; 444; 5; 750; 306 
1; 148; 447; 5; 755; 308 
1; 149; 450; 5; 760; 310 
1; 150; 453; 5; 765; 312 
1; 151; 456; 5; 770; 314 
1; 152; 459; 5; 775; 316 
1; 153; 462; 5; 780; 318 
1; 154; 465; 5; 785; 320 
1; 155; 468; 5; 790; 322 
1; 156; 471; 5; 795; 324 
1; 157; 474; 5; 800; 326 
1; 158; 477; 5; 805; 328 
1; 159; 480; 5; 810; 330 
1; 160; 483; 5; 815; 332 
1; 161; 486; 5; 820; 334 
1; 162; 489; 5; 825; 336 
1; 163; 492; 5; 830; 338 
1; 164; 495; 5; 835; 340 
1; 165; 498; 5; 840; 342 
1; 166; 501; 5; 845; 344 
1; 167; 504; 5; 850; 346 
1; 168; 507; 5; 855; 348 
1; 169; 510; 5; 860; 350 
1; 170; 513; 5; 865; 352 
1; 171; 516; 5; 870; 354 
1; 172; 519; 5; 875; 356 
1; 173; 522; 5; 880; 358 
1; 174; 525; 5; 885; 360 
1; 175; 528; 5; 890; 362 
1; 176; 531; 5; 895; 364 
1; 177; 534; 5; 900; 366 
1; 178; 537; 5; 905; 368 
1; 179; 540; 5; 910; 370 
1; 180; 543; 5; 915; 372 
1; 181; 546; 5; 920; 374 
1; 182; 549; 5; 925; 376 
1; 183; 552; 5; 930; 378 
1; 184; 555; 5; 935; 380 
1; 185; 558; 5; 940; 382 
1; 186; 561; 5; 945; 384 
1; 187; 564; 5; 950; 386 
1; 188; 567; 5; 955; 388 
1; 189; 570; 5; 960; 390 
1; 190; 573; 5; 965; 392 
1; 191; 576; 5; 970; 394 
1; 192; 579; 5; 975; 396 
1; 193; 582; 5; 980; 398 
1; 194; 585; 5; 985; 400 
1; 195; 588; 5; 990; 402 
1; 196; 591; 5; 995; 404 
1; 197; 594; 5; 1000; 406 
1; 198; 597; 5; 1005; 408 
1; 199; 600; 5; 1010; 410 
1; 200; 603; 5; 1015; 412 
1; 201; 606; 5; 1020; 414 
1; 202; 609; 5; 1025; 416 
1; 203; 612; 5; 1030; 418 
1; 204; 615; 5; 1035; 420 
1; 205; 618; 5; 1040; 422 
1; 206; 621; 5; 1045; 424 
1; 207; 624; 5; 1050; 426 
1; 208; 627; 5; 1055; 428 
1; 209; 630; 5; 1060; 430 
1; 210; 633; 5; 1065; 432 
1; 211; 636; 5; 1070; 434 
1; 212; 639; 5; 1075; 436 
1; 213; 642; 5; 1080; 438 
1; 214; 645; 5; 1085; 440 
1; 215; 648; 5; 1090; 442 
1; 216; 651; 5; 1095; 444 
1; 217; 654; 5; 1100; 446 
1; 218; 657; 5; 1105; 448 
1; 219; 660; 5; 1110; 450 
1; 220; 663; 5; 1115; 452 
1; 221; 666; 5; 1120; 454 
1; 222; 669; 5; 1125; 456 
1; 223; 672; 5; 1130; 458 
1; 224; 675; 5; 1135; 460 
1; 225; 678; 5; 1140; 462 
1; 226; 681; 5; 1145; 464 
1; 227; 684; 5; 1150; 466 
1; 228; 687; 5; 1155; 468 
1; 229; 690; 5; 1160; 470 
1; 230; 693; 5; 1165; 472 
1; 231; 696; 5; 1170; 474 
1; 232; 699; 5; 1175; 476 
1; 233; 702; 5; 1180; 478 
1; 234; 705; 5; 1185; 480 
1; 235; 708; 5; 1190; 482 
1; 236; 711; 5; 1195; 484 
1; 237; 714; 5; 1200; 486 
1; 238; 717; 5; 1205; 488 
1; 239; 720; 5; 1210; 490 
1; 240; 723; 5; 1215; 492 
1; 241; 726; 5; 1220; 494 
1; 242; 729; 5; 1225; 496 
1; 243; 732; 5; 1230; 498 
1; 244; 735; 5; 1235; 500 
1; 245; 738; 5; 1240; 502 
1; 246; 741; 5; 1245; 504 
1; 247; 744; 5; 1250; 506 
1; 248; 747; 5; 1255; 508 
1; 249; 750; 5; 1260; 510 
1; 250; 753; 5; 1265; 512 
1; 251; 756; 5; 1270; 514 
1; 252; 759; 5; 1275; 516 
1; 253; 762; 5; 1280; 518 
1; 254; 765; 5; 1285; 520 
1; 255; 768; 5; 1290; 522 
1; 256; 771; 5; 1295; 524 
1; 257; 774; 5; 1300; 526 
1; 258; 777; 5; 1305; 528 
1; 259; 780; 5; 1310; 530 
1; 260; 783; 5; 1315; 532 
1; 261; 786; 5; 1320; 534 
1; 262; 789; 5; 1325; 536 
1; 263; 792; 5; 1330; 538 
1; 264; 795; 5; 1335; 540 
1; 265; 798; 5; 1340; 542 
1; 266; 801; 5; 1345; 544 
1; 267; 804; 5; 1350; 546 
1; 268; 807; 5; 1355; 548 
1; 269; 810; 5; 1360; 550 
1; 270; 813; 5; 1365; 552 
1; 271; 816; 5; 1370; 554 
1; 272; 819; 5; 1375; 556 
1; 273; 822; 5; 1380; 558 
1; 274; 825; 5; 1385; 560 
1; 275; 828; 5; 1390; 562 
1; 276; 831; 5; 1395; 564 
1; 277; 834; 5; 1400; 566 
1; 278; 837; 5; 1405; 568 
1; 279; 840; 5; 1410; 570 
1; 280; 843; 5; 1415; 572 
1; 281; 846; 5; 1420; 574 
1; 282; 849; 5; 1425; 576 
1; 283; 852; 5; 1430; 578 
1; 284; 855; 5; 1435; 580 
1; 285; 858; 5; 1440; 582 
1; 286; 861; 5; 1445; 584 
1; 287; 864; 5; 1450; 586 
1; 288; 867; 5; 1455; 588 
1; 289; 870; 5; 1460; 590 
1; 290; 873; 5; 1465; 592 
1; 291; 876; 5; 1470; 594 
1; 292; 879; 5; 1475; 596 
1; 293; 882; 5; 1480; 598 
1; 294; 885; 5; 1485; 600 
1; 295; 888; 5; 1490; 602 
1; 296; 891; 5; 1495; 604 
1; 297; 894; 5; 1500; 606 
1; 298; 897; 5; 1505; 608 
1; 299; 900; 5; 1510; 610 
1; 300; 903; 5; 1515; 612 
1; 301; 906; 5; 1520; 614 
1; 302; 909; 5; 1525; 616 
1; 303; 912; 5; 1530; 618 
1; 304; 915; 5; 1535; 620 
1; 305; 918; 5; 1540; 622 
1; 306; 921; 5; 1545; 624 
1; 307; 924; 5; 1550; 626 
1; 308; 927; 5; 1555; 628 
1; 309; 930; 5; 1560; 630 
1; 310; 933; 5; 1565; 632 
1; 311; 936; 5; 1570; 634 
1; 312; 939; 5; 1575; 636 
1; 313; 942; 5; 1580; 638 
1; 314; 945; 5; 1585; 640 
1; 315; 948; 5; 1590; 642 
1; 316; 951; 5; 1595; 644 
1; 317; 954; 5; 1600; 646 
1; 318; 957; 5; 1605; 648 
1; 319; 960; 5; 1610; 650 
1; 320; 963; 5; 1615; 652 
1; 321; 966; 5; 1620; 654 
1; 322; 969; 5; 1625; 656 
1; 323; 972; 5; 1630; 658 
1; 324; 975; 5; 1635; 660 
1; 325; 978; 5; 1640; 662 
1; 326; 981; 5; 1645; 664 
1; 327; 984; 5; 1650; 666 
1; 328; 987; 5; 1655; 668 
1; 329; 990; 5; 1660; 670 
1; 330; 993; 5; 1665; 672 
1; 331; 996; 5; 1670; 674 
1; 332; 999; 5; 1675; 676 
1; 333; 1002; 5; 1680; 678 
1; 334; 1005; 5; 1685; 680 
1; 335; 1008; 5; 1690; 682 
1; 336; 1011; 5; 1695; 684 
1; 337; 1014; 5; 1700; 686 
1; 338; 1017; 5; 1705; 688 
1; 339; 1020; 5; 1710; 690 
1; 340; 1023; 5; 1715; 692 
1; 341; 1026; 5; 1720; 694 
1; 342; 1029; 5; 1725; 696 
1; 343; 1032; 5; 1730; 698 
1; 344; 1035; 5; 1735; 700 
1; 345; 1038; 5; 1740; 702 
1; 346; 1041; 5; 1745; 704 
1; 347; 1044; 5; 1750; 706 
1; 348; 1047; 5; 1755; 708 
1; 349; 1050; 5; 1760; 710 
1; 350; 1053; 5; 1765; 712 
1; 351; 1056; 5; 1770; 714 
1; 352; 1059; 5; 1775; 716 
1; 353; 1062; 5; 1780; 718 
1; 354; 1065; 5; 1785; 720 
1; 355; 1068; 5; 1790; 722 
1; 356; 1071; 5; 1795; 724 
1; 357; 1074; 5; 1800; 726 
1; 358; 1077; 5; 1805; 728 
1; 359; 1080; 5; 1810; 730 
1; 360; 1083; 5; 1815; 732 
1; 361; 1086; 5; 1820; 734 
1; 362; 1089; 5; 1825; 736 
1; 363; 1092; 5; 1830; 738 
1; 364; 1095; 5; 1835; 740 
1; 365; 1098; 5; 1840; 742 
1; 366; 1101; 5; 1845; 744 
1; 367; 1104; 5; 1850; 746 
1; 368; 1107; 5; 1855; 748 
1; 369; 1110; 5; 1860; 750 
1; 370; 1113; 5; 1865; 752 
1; 371; 1116; 5; 1870; 754 
1; 372; 1119; 5; 1875; 756 
1; 373; 1122; 5; 1880; 758 
1; 374; 1125; 5; 1885; 760 
1; 375; 1128; 5; 1890; 762 
1; 376; 1131; 5; 1895; 764 
1; 377; 1134; 5; 1900; 766 
1; 378; 1137; 5; 1905; 768 
1; 379; 1140; 5; 1910; 770 
1; 380; 1143; 5; 1915; 772 
1; 381; 1146; 5; 1920; 774 
1; 382; 1149; 5; 1925; 776 
1; 383; 1152; 5; 1930; 778 
1; 384; 1155; 5; 1935; 780 
1; 385; 1158; 5; 1940; 782 
1; 386; 1161; 5; 1945; 784 
1; 387; 1164; 5; 1950; 786 
1; 388; 1167; 5; 1955; 788 
1; 389; 1170; 5; 1960; 790 
1; 390; 1173; 5; 1965; 792 
1; 391; 1176; 5; 1970; 794 
1; 392; 1179; 5; 1975; 796 
1; 393; 1182; 5; 1980; 798 
1; 394; 1185; 5; 1985; 800 
1; 395; 1188; 5; 1990; 802 
1; 396; 1191; 5; 1995; 804 
1; 397; 1194; 5; 2000; 806 
1; 398; 1197; 5; 2005; 808 
1; 399; 1200; 5; 2010; 810 
1; 400; 1203; 5; 2015; 812 
1; 401; 1206; 5; 2020; 814 
1; 402; 1209; 5; 2025; 816 
1; 403; 1212; 5; 2030; 818 
1; 404; 1215; 5; 2035; 820 
1; 405; 1218; 5; 2040; 822 
1; 406; 1221; 5; 2045; 824 
1; 407; 1224; 5; 2050; 826 
1; 408; 1227; 5; 2055; 828 
1; 409; 1230; 5; 2060; 830 
1; 410; 1233; 5; 2065; 832 
1; 411; 1236; 5; 2070; 834 
1; 412; 1239; 5; 2075; 836 
1; 413; 1242; 5; 2080; 838 
1; 414; 1245; 5; 2085; 840 
1; 415; 1248; 5; 2090; 842 
1; 416; 1251; 5; 2095; 844 
1; 417; 1254; 5; 2100; 846 
1; 418; 1257; 5; 2105; 848 
1; 419; 1260; 5; 2110; 850 
1; 420; 1263; 5; 2115; 852 
1; 421; 1266; 5; 2120; 854 
1; 422; 1269; 5; 2125; 856 
1; 423; 1272; 5; 2130; 858 
1; 424; 1275; 5; 2135; 860 
1; 425; 1278; 5; 2140; 862 
1; 426; 1281; 5; 2145; 864 
1; 427; 1284; 5; 2150; 866 
1; 428; 1287; 5; 2155; 868 
1; 429; 1290; 5; 2160; 870 
1; 430; 1293; 5; 2165; 872 
1; 431; 1296; 5; 2170; 874 
1; 432; 1299; 5; 2175; 876 
1; 433; 1302; 5; 2180; 878 
1; 434; 1305; 5; 2185; 880 
1; 435; 1308; 5; 2190; 882 
1; 436; 1311; 5; 2195; 884 
1; 437; 1314; 5; 2200; 886 
1; 438; 1317; 5; 2205; 888 
1; 439; 1320; 5; 2210; 890 
1; 440; 1323; 5; 2215; 892 
1; 441; 1326; 5; 2220; 894 
1; 442; 1329; 5; 2225; 896 
1; 443; 1332; 5; 2230; 898 
1; 444; 1335; 5; 2235; 900 
1; 445; 1338; 5; 2240; 902 
1; 446; 1341; 5; 2245; 904 
1; 447; 1344; 5; 2250; 906 
1; 448; 1347; 5; 2255; 908 
1; 449; 1350; 5; 2260; 910 
1; 450; 1353; 5; 2265; 912 
1; 451; 1356; 5; 2270; 914 
1; 452; 1359; 5; 2275; 916 
1; 453; 1362; 5; 2280; 918 
1; 454; 1365; 5; 2285; 920 
1; 455; 1368; 5; 2290; 922 
1; 456; 1371; 5; 2295; 924 
1; 457; 1374; 5; 2300; 926 
1; 458; 1377; 5; 2305; 928 
1; 459; 1380; 5; 2310; 930 
1; 460; 1383; 5; 2315; 932 
1; 461; 1386; 5; 2320; 934 
1; 462; 1389; 5; 2325; 936 
1; 463; 1392; 5; 2330; 938 
1; 464; 1395; 5; 2335; 940 
1; 465; 1398; 5; 2340; 942 
1; 466; 1401; 5; 2345; 944 
1; 467; 1404; 5; 2350; 946 
1; 468; 1407; 5; 2355; 948 
1; 469; 1410; 5; 2360; 950 
1; 470; 1413; 5; 2365; 952 
1; 471; 1416; 5; 2370; 954 
1; 472; 1419; 5; 2375; 956 
1; 473; 1422; 5; 2380; 958 
1; 474; 1425; 5; 2385; 960 
1; 475; 1428; 5; 2390; 962 
1; 476; 1431; 5; 2395; 964 
1; 477; 1434; 5; 2400; 966 
1; 478; 1437; 5; 2405; 968 
1; 479; 1440; 5; 2410; 970 
1; 480; 1443; 5; 2415; 972 
1; 481; 1446; 5; 2420; 974 
1; 482; 1449; 5; 2425; 976 
1; 483; 1452; 5; 2430; 978 
1; 484; 1455; 5; 2435; 980 
1; 485; 1458; 5; 2440; 982 
1; 486; 1461; 5; 2445; 984 
1; 487; 1464; 5; 2450; 986 
1; 488; 1467; 5; 2455; 988 
1; 489; 1470; 5; 2460; 990 
1; 490; 1473; 5; 2465; 992 
1; 491; 1476; 5; 2470; 994 
1; 492; 1479; 5; 2475; 996 
1; 493; 1482; 5; 2480; 998 
1; 494; 1485; 5; 2485; 1000 
1; 495; 1488; 5; 2490; 1002 
1; 496; 1491; 5; 2495; 1004 
1; 497; 1494; 5; 2500; 1006 
1; 498; 1497; 5; 2505; 1008 
1; 499; 1500; 5; 2510; 1010 
1; 500; 1503; 5; 2515; 1012 
1; 501; 1506; 5; 2520; 1014 
1; 502; 1509; 5; 2525; 1016 
1; 503; 1512; 5; 2530; 1018 
1; 504; 1515; 5; 2535; 1020 
1; 505; 1518; 5; 2540; 1022 
1; 506; 1521; 5; 2545; 1024 
1; 507; 1524; 5; 2550; 1026 
1; 508; 1527; 5; 2555; 1028 
1; 509; 1530; 5; 2560; 1030 
1; 510; 1533; 5; 2565; 1032 
1; 511; 1536; 5; 2570; 1034 
1; 512; 1539; 5; 2575; 1036 
1; 513; 1542; 5; 2580; 1038 
1; 514; 1545; 5; 2585; 1040 
1; 515; 1548; 5; 2590; 1042 
1; 516; 1551; 5; 2595; 1044 
1; 517; 1554; 5; 2600; 1046 
1; 518; 1557; 5; 2605; 1048 
1; 519; 1560; 5; 2610; 1050 
1; 520; 1563; 5; 2615; 1052 
1; 521; 1566; 5; 2620; 1054 
1; 522; 1569; 5; 2625; 1056 
1; 523; 1572; 5; 2630; 1058 
1; 524; 1575; 5; 2635; 1060 
1; 525; 1578; 5; 2640; 1062 
1; 526; 1581; 5; 2645; 1064 
1; 527; 1584; 5; 2650; 1066 
1; 528; 1587; 5; 2655; 1068 
1; 529; 1590; 5; 2660; 1070 
1; 530; 1593; 5; 2665; 1072 
1; 531; 1596; 5; 2670; 1074 
1; 532; 1599; 5; 2675; 1076 
1; 533; 1602; 5; 2680; 1078 
1; 534; 1605; 5; 2685; 1080 
1; 535; 1608; 5; 2690; 1082 
1; 536; 1611; 5; 2695; 1084 
1; 537; 1614; 5; 2700; 1086 
1; 538; 1617; 5; 2705; 1088 
1; 539; 1620; 5; 2710; 1090 
1; 540; 1623; 5; 2715; 1092 
1; 541; 1626; 5; 2720; 1094 
1; 542; 1629; 5; 2725; 1096 
1; 543; 1632; 5; 2730; 1098 
1; 544; 1635; 5; 2735; 1100 
1; 545; 1638; 5; 2740; 1102 
1; 546; 1641; 5; 2745; 1104 
1; 547; 1644; 5; 2750; 1106 
1; 548; 1647; 5; 2755; 1108 
1; 549; 1650; 5; 2760; 1110 
1; 550; 1653; 5; 2765; 1112 
1; 551; 1656; 5; 2770; 1114 
1; 552; 1659; 5; 2775; 1116 
1; 553; 1662; 5; 2780; 1118 
1; 554; 1665; 5; 2785; 1120 
1; 555; 1668; 5; 2790; 1122 
1; 556; 1671; 5; 2795; 1124 
1; 557; 1674; 5; 2800; 1126 
1; 558; 1677; 5; 2805; 1128 
1; 559; 1680; 5; 2810; 1130 
1; 560; 1683; 5; 2815; 1132 
1; 561; 1686; 5; 2820; 1134 
1; 562; 1689; 5; 2825; 1136 
1; 563; 1692; 5; 2830; 1138 
1; 564; 1695; 5; 2835; 1140 
1; 565; 1698; 5; 2840; 1142 
1; 566; 1701; 5; 2845; 1144 
1; 567; 1704; 5; 2850; 1146 
1; 568; 1707; 5; 2855; 1148 
1; 569; 1710; 5; 2860; 1150 
1; 570; 1713; 5; 2865; 1152 
1; 571; 1716; 5; 2870; 1154 
1; 572; 1719; 5; 2875; 1156 
1; 573; 1722; 5; 2880; 1158 
1; 574; 1725; 5; 2885; 1160 
1; 575; 1728; 5; 2890; 1162 
1; 576; 1731; 5; 2895; 1164 
1; 577; 1734; 5; 2900; 1166 
1; 578; 1737; 5; 2905; 1168 
1; 579; 1740; 5; 2910; 1170 
1; 580; 1743; 5; 2915; 1172 
1; 581; 1746; 5; 2920; 1174 
1; 582; 1749; 5; 2925; 1176 
1; 583; 1752; 5; 2930; 1178 
1; 584; 1755; 5; 2935; 1180 
1; 585; 1758; 5; 2940; 1182 
1; 586; 1761; 5; 2945; 1184 
1; 587; 1764; 5; 2950; 1186 
1; 588; 1767; 5; 2955; 1188 
1; 589; 1770; 5; 2960; 1190 
1; 590; 1773; 5; 2965; 1192 
1; 591; 1776; 5; 2970; 1194 
1; 592; 1779; 5; 2975; 1196 
1; 593; 1782; 5; 2980; 1198 
1; 594; 1785; 5; 2985; 1200 
1; 595; 1788; 5; 2990; 1202 
1; 596; 1791; 5; 2995; 1204 
1; 597; 1794; 5; 3000; 1206 
1; 598; 1797; 5; 3005; 1208 
1; 599; 1800; 5; 3010; 1210 
1; 600; 1803; 5; 3015; 1212 
1; 601; 1806; 5; 3020; 1214 
1; 602; 1809; 5; 3025; 1216 
1; 603; 1812; 5; 3030; 1218 
1; 604; 1815; 5; 3035; 1220 
1; 605; 1818; 5; 3040; 1222 
1; 606; 1821; 5; 3045; 1224 
1; 607; 1824; 5; 3050; 1226 
1; 608; 1827; 5; 3055; 1228 
1; 609; 1830; 5; 3060; 1230 
1; 610; 1833; 5; 3065; 1232 
1; 611; 1836; 5; 3070; 1234 
1; 612; 1839; 5; 3075; 1236 
1; 613; 1842; 5; 3080; 1238 
1; 614; 1845; 5; 3085; 1240 
1; 615; 1848; 5; 3090; 1242 
1; 616; 1851; 5; 3095; 1244 
1; 617; 1854; 5; 3100; 1246 
1; 618; 1857; 5; 3105; 1248 
1; 619; 1860; 5; 3110; 1250 
1; 620; 1863; 5; 3115; 1252 
1; 621; 1866; 5; 3120; 1254 
1; 622; 1869; 5; 3125; 1256 
1; 623; 1872; 5; 3130; 1258 
1; 624; 1875; 5; 3135; 1260 
1; 625; 1878; 5; 3140; 1262 
1; 626; 1881; 5; 3145; 1264 
1; 627; 1884; 5; 3150; 1266 
1; 628; 1887; 5; 3155; 1268 
1; 629; 1890; 5; 3160; 1270 
1; 630; 1893; 5; 3165; 1272 
1; 631; 1896; 5; 3170; 1274 
1; 632; 1899; 5; 3175; 1276 
1; 633; 1902; 5; 3180; 1278 
1; 634; 1905; 5; 3185; 1280 
1; 635; 1908; 5; 3190; 1282 
1; 636; 1911; 5; 3195; 1284 
1; 637; 1914; 5; 3200; 1286 
1; 638; 1917; 5; 3205; 1288 
1; 639; 1920; 5; 3210; 1290 
1; 640; 1923; 5; 3215; 1292 
1; 641; 1926; 5; 3220; 1294 
1; 642; 1929; 5; 3225; 1296 
1; 643; 1932; 5; 3230; 1298 
1; 644; 1935; 5; 3235; 1300 
1; 645; 1938; 5; 3240; 1302 
1; 646; 1941; 5; 3245; 1304 
1; 647; 1944; 5; 3250; 1306 
1; 648; 1947; 5; 3255; 1308 
1; 649; 1950; 5; 3260; 1310 
1; 650; 1953; 5; 3265; 1312 
1; 651; 1956; 5; 3270; 1314 
1; 652; 1959; 5; 3275; 1316 
1; 653; 1962; 5; 3280; 1318 
1; 654; 1965; 5; 3285; 1320 
1; 655; 1968; 5; 3290; 1322 
1; 656; 1971; 5; 3295; 1324 
1; 657; 1974; 5; 3300; 1326 
1; 658; 1977; 5; 3305; 1328 
1; 659; 1980; 5; 3310; 1330 
1; 660; 1983; 5; 3315; 1332 
1; 661; 1986; 5; 3320; 1334 
1; 662; 1989; 5; 3325; 1336 
1; 663; 1992; 5; 3330; 1338 
1; 664; 1995; 5; 3335; 1340 
1; 665; 1998; 5; 3340; 1342 
1; 666; 2001; 5; 3345; 1344 
1; 667; 2004; 5; 3350; 1346 
1; 668; 2007; 5; 3355; 1348 
1; 669; 2010; 5; 3360; 1350 
1; 670; 2013; 5; 3365; 1352 
1; 671; 2016; 5; 3370; 1354 
1; 672; 2019; 5; 3375; 1356 
1; 673; 2022; 5; 3380; 1358 
1; 674; 2025; 5; 3385; 1360 
1; 675; 2028; 5; 3390; 1362 
1; 676; 2031; 5; 3395; 1364 
1; 677; 2034; 5; 3400; 1366 
1; 678; 2037; 5; 3405; 1368 
1; 679; 2040; 5; 3410; 1370 
1; 680; 2043; 5; 3415; 1372 
1; 681; 2046; 5; 3420; 1374 
1; 682; 2049; 5; 3425; 1376 
1; 683; 2052; 5; 3430; 1378 
1; 684; 2055; 5; 3435; 1380 
1; 685; 2058; 5; 3440; 1382 
1; 686; 2061; 5; 3445; 1384 
1; 687; 2064; 5; 3450; 1386 
1; 688; 2067; 5; 3455; 1388 
1; 689; 2070; 5; 3460; 1390 
1; 690; 2073; 5; 3465; 1392 
1; 691; 2076; 5; 3470; 1394 
1; 692; 2079; 5; 3475; 1396 
1; 693; 2082; 5; 3480; 1398 
1; 694; 2085; 5; 3485; 1400 
1; 695; 2088; 5; 3490; 1402 
1; 696; 2091; 5; 3495; 1404 
1; 697; 2094; 5; 3500; 1406 
1; 698; 2097; 5; 3505; 1408 
1; 699; 2100; 5; 3510; 1410 
1; 700; 2103; 5; 3515; 1412 
1; 701; 2106; 5; 3520; 1414 
1; 702; 2109; 5; 3525; 1416 
1; 703; 2112; 5; 3530; 1418 
1; 704; 2115; 5; 3535; 1420 
1; 705; 2118; 5; 3540; 1422 
1; 706; 2121; 5; 3545; 1424 
1; 707; 2124; 5; 3550; 1426 
1; 708; 2127; 5; 3555; 1428 
1; 709; 2130; 5; 3560; 1430 
1; 710; 2133; 5; 3565; 1432 
1; 711; 2136; 5; 3570; 1434 
1; 712; 2139; 5; 3575; 1436 
1; 713; 2142; 5; 3580; 1438 
1; 714; 2145; 5; 3585; 1440 
1; 715; 2148; 5; 3590; 1442 
1; 716; 2151; 5; 3595; 1444 
1; 717; 2154; 5; 3600; 1446 
1; 718; 2157; 5; 3605; 1448 
1; 719; 2160; 5; 3610; 1450 
1; 720; 2163; 5; 3615; 1452 
1; 721; 2166; 5; 3620; 1454 
1; 722; 2169; 5; 3625; 1456 
1; 723; 2172; 5; 3630; 1458 
1; 724; 2175; 5; 3635; 1460 
1; 725; 2178; 5; 3640; 1462 
1; 726; 2181; 5; 3645; 1464 
1; 727; 2184; 5; 3650; 1466 
1; 728; 2187; 5; 3655; 1468 
1; 729; 2190; 5; 3660; 1470 
1; 730; 2193; 5; 3665; 1472 
1; 731; 2196; 5; 3670; 1474 
1; 732; 2199; 5; 3675; 1476 
1; 733; 2202; 5; 3680; 1478 
1; 734; 2205; 5; 3685; 1480 
1; 735; 2208; 5; 3690; 1482 
1; 736; 2211; 5; 3695; 1484 
1; 737; 2214; 5; 3700; 1486 
1; 738; 2217; 5; 3705; 1488 
1; 739; 2220; 5; 3710; 1490 
1; 740; 2223; 5; 3715; 1492 
1; 741; 2226; 5; 3720; 1494 
1; 742; 2229; 5; 3725; 1496 
1; 743; 2232; 5; 3730; 1498 
1; 744; 2235; 5; 3735; 1500 
1; 745; 2238; 5; 3740; 1502 
1; 746; 2241; 5; 3745; 1504 
1; 747; 2244; 5; 3750; 1506 
1; 748; 2247; 5; 3755; 1508 
1; 749; 2250; 5; 3760; 1510 
1; 750; 2253; 5; 3765; 1512 
1; 751; 2256; 5; 3770; 1514 
1; 752; 2259; 5; 3775; 1516 
1; 753; 2262; 5; 3780; 1518 
1; 754; 2265; 5; 3785; 1520 
1; 755; 2268; 5; 3790; 1522 
1; 756; 2271; 5; 3795; 1524 
1; 757; 2274; 5; 3800; 1526 
1; 758; 2277; 5; 3805; 1528 
1; 759; 2280; 5; 3810; 1530 
1; 760; 2283; 5; 3815; 1532 
1; 761; 2286; 5; 3820; 1534 
1; 762; 2289; 5; 3825; 1536 
1; 763; 2292; 5; 3830; 1538 
1; 764; 2295; 5; 3835; 1540 
1; 765; 2298; 5; 3840; 1542 
1; 766; 2301; 5; 3845; 1544 
1; 767; 2304; 5; 3850; 1546 
1; 768; 2307; 5; 3855; 1548 
1; 769; 2310; 5; 3860; 1550 
1; 770; 2313; 5; 3865; 1552 
1; 771; 2316; 5; 3870; 1554 
1; 772; 2319; 5; 3875; 1556 
1; 773; 2322; 5; 3880; 1558 
1; 774; 2325; 5; 3885; 1560 
1; 775; 2328; 5; 3890; 1562 
1; 776; 2331; 5; 3895; 1564 
1; 777; 2334; 5; 3900; 1566 
1; 778; 2337; 5; 3905; 1568 
1; 779; 2340; 5; 3910; 1570 
1; 780; 2343; 5; 3915; 1572 
1; 781; 2346; 5; 3920; 1574 
1; 782; 2349; 5; 3925; 1576 
1; 783; 2352; 5; 3930; 1578 
1; 784; 2355; 5; 3935; 1580 
1; 785; 2358; 5; 3940; 1582 
1; 786; 2361; 5; 3945; 1584 
1; 787; 2364; 5; 3950; 1586 
1; 788; 2367; 5; 3955; 1588 
1; 789; 2370; 5; 3960; 1590 
1; 790; 2373; 5; 3965; 1592 
1; 791; 2376; 5; 3970; 1594 
1; 792; 2379; 5; 3975; 1596 
1; 793; 2382; 5; 3980; 1598 
1; 794; 2385; 5; 3985; 1600 
1; 795; 2388; 5; 3990; 1602 
1; 796; 2391; 5; 3995; 1604 
1; 797; 2394; 5; 4000; 1606 
1; 798; 2397; 5; 4005; 1608 
1; 799; 2400; 5; 4010; 1610 
1; 800; 2403; 5; 4015; 1612 
1; 801; 2406; 5; 4020; 1614 
1; 802; 2409; 5; 4025; 1616 
1; 803; 2412; 5; 4030; 1618 
1; 804; 2415; 5; 4035; 1620 
1; 805; 2418; 5; 4040; 1622 
1; 806; 2421; 5; 4045; 1624 
1; 807; 2424; 5; 4050; 1626 
1; 808; 2427; 5; 4055; 1628 
1; 809; 2430; 5; 4060; 1630 
1; 810; 2433; 5; 4065; 1632 
1; 811; 2436; 5; 4070; 1634 
1; 812; 2439; 5; 4075; 1636 
1; 813; 2442; 5; 4080; 1638 
1; 814; 2445; 5; 4085; 1640 
1; 815; 2448; 5; 4090; 1642 
1; 816; 2451; 5; 4095; 1644 
1; 817; 2454; 5; 4100; 1646 
1; 818; 2457; 5; 4105; 1648 
1; 819; 2460; 5; 4110; 1650 
1; 820; 2463; 5; 4115; 1652 
1; 821; 2466; 5; 4120; 1654 
1; 822; 2469; 5; 4125; 1656 
1; 823; 2472; 5; 4130; 1658 
1; 824; 2475; 5; 4135; 1660 
1; 825; 2478; 5; 4140; 1662 
1; 826; 2481; 5; 4145; 1664 
1; 827; 2484; 5; 4150; 1666 
1; 828; 2487; 5; 4155; 1668 
1; 829; 2490; 5; 4160; 1670 
1; 830; 2493; 5; 4165; 1672 
1; 831; 2496; 5; 4170; 1674 
1; 832; 2499; 5; 4175; 1676 
1; 833; 2502; 5; 4180; 1678 
1; 834; 2505; 5; 4185; 1680 
1; 835; 2508; 5; 4190; 1682 
1; 836; 2511; 5; 4195; 1684 
1; 837; 2514; 5; 4200; 1686 
1; 838; 2517; 5; 4205; 1688 
1; 839; 2520; 5; 4210; 1690 
1; 840; 2523; 5; 4215; 1692 
1; 841; 2526; 5; 4220; 1694 
1; 842; 2529; 5; 4225; 1696 
1; 843; 2532; 5; 4230; 1698 
1; 844; 2535; 5; 4235; 1700 
1; 845; 2538; 5; 4240; 1702 
1; 846; 2541; 5; 4245; 1704 
1; 847; 2544; 5; 4250; 1706 
1; 848; 2547; 5; 4255; 1708 
1; 849; 2550; 5; 4260; 1710 
1; 850; 2553; 5; 4265; 1712 
1; 851; 2556; 5; 4270; 1714 
1; 852; 2559; 5; 4275; 1716 
1; 853; 2562; 5; 4280; 1718 
1; 854; 2565; 5; 4285; 1720 
1; 855; 2568; 5; 4290; 1722 
1; 856; 2571; 5; 4295; 1724 
1; 857; 2574; 5; 4300; 1726 
1; 858; 2577; 5; 4305; 1728 
1; 859; 2580; 5; 4310; 1730 
1; 860; 2583; 5; 4315; 1732 
1; 861; 2586; 5; 4320; 1734 
1; 862; 2589; 5; 4325; 1736 
1; 863; 2592; 5; 4330; 1738 
1; 864; 2595; 5; 4335; 1740 
1; 865; 2598; 5; 4340; 1742 
1; 866; 2601; 5; 4345; 1744 
1; 867; 2604; 5; 4350; 1746 
1; 868; 2607; 5; 4355; 1748 
1; 869; 2610; 5; 4360; 1750 
1; 870; 2613; 5; 4365; 1752 
1; 871; 2616; 5; 4370; 1754 
1; 872; 2619; 5; 4375; 1756 
1; 873; 2622; 5; 4380; 1758 
1; 874; 2625; 5; 4385; 1760 
1; 875; 2628; 5; 4390; 1762 
1; 876; 2631; 5; 4395; 1764 
1; 877; 2634; 5; 4400; 1766 
1; 878; 2637; 5; 4405; 1768 
1; 879; 2640; 5; 4410; 1770 
1; 880; 2643; 5; 4415; 1772 
1; 881; 2646; 5; 4420; 1774 
1; 882; 2649; 5; 4425; 1776 
1; 883; 2652; 5; 4430; 1778 
1; 884; 2655; 5; 4435; 1780 
1; 885; 2658; 5; 4440; 1782 
1; 886; 2661; 5; 4445; 1784 
1; 887; 2664; 5; 4450; 1786 
1; 888; 2667; 5; 4455; 1788 
1; 889; 2670; 5; 4460; 1790 
1; 890; 2673; 5; 4465; 1792 
1; 891; 2676; 5; 4470; 1794 
1; 892; 2679; 5; 4475; 1796 
1; 893; 2682; 5; 4480; 1798 
1; 894; 2685; 5; 4485; 1800 
1; 895; 2688; 5; 4490; 1802 
1; 896; 2691; 5; 4495; 1804 
1; 897; 2694; 5; 4500; 1806 
1; 898; 2697; 5; 4505; 1808 
1; 899; 2700; 5; 4510; 1810 
1; 900; 2703; 5; 4515; 1812 
1; 901; 2706; 5; 4520; 1814 
1; 902; 2709; 5; 4525; 1816 
1; 903; 2712; 5; 4530; 1818 
1; 904; 2715; 5; 4535; 1820 
1; 905; 2718; 5; 4540; 1822 
1; 906; 2721; 5; 4545; 1824 
1; 907; 2724; 5; 4550; 1826 
1; 908; 2727; 5; 4555; 1828 
1; 909; 2730; 5; 4560; 1830 
1; 910; 2733; 5; 4565; 1832 
1; 911; 2736; 5; 4570; 1834 
1; 912; 2739; 5; 4575; 1836 
1; 913; 2742; 5; 4580; 1838 
1; 914; 2745; 5; 4585; 1840 
1; 915; 2748; 5; 4590; 1842 
1; 916; 2751; 5; 4595; 1844 
1; 917; 2754; 5; 4600; 1846 
1; 918; 2757; 5; 4605; 1848 
1; 919; 2760; 5; 4610; 1850 
1; 920; 2763; 5; 4615; 1852 
1; 921; 2766; 5; 4620; 1854 
1; 922; 2769; 5; 4625; 1856 
1; 923; 2772; 5; 4630; 1858 
1; 924; 2775; 5; 4635; 1860 
1; 925; 2778; 5; 4640; 1862 
1; 926; 2781; 5; 4645; 1864 
1; 927; 2784; 5; 4650; 1866 
1; 928; 2787; 5; 4655; 1868 
1; 929; 2790; 5; 4660; 1870 
1; 930; 2793; 5; 4665; 1872 
1; 931; 2796; 5; 4670; 1874 
1; 932; 2799; 5; 4675; 1876 
1; 933; 2802; 5; 4680; 1878 
1; 934; 2805; 5; 4685; 1880 
1; 935; 2808; 5; 4690; 1882 
1; 936; 2811; 5; 4695; 1884 
1; 937; 2814; 5; 4700; 1886 
1; 938; 2817; 5; 4705; 1888 
1; 939; 2820; 5; 4710; 1890 
1; 940; 2823; 5; 4715; 1892 
1; 941; 2826; 5; 4720; 1894 
1; 942; 2829; 5; 4725; 1896 
1; 943; 2832; 5; 4730; 1898 
1; 944; 2835; 5; 4735; 1900 
1; 945; 2838; 5; 4740; 1902 
1; 946; 2841; 5; 4745; 1904 
1; 947; 2844; 5; 4750; 1906 
1; 948; 2847; 5; 4755; 1908 
1; 949; 2850; 5; 4760; 1910 
1; 950; 2853; 5; 4765; 1912 
1; 951; 2856; 5; 4770; 1914 
1; 952; 2859; 5; 4775; 1916 
1; 953; 2862; 5; 4780; 1918 
1; 954; 2865; 5; 4785; 1920 
1; 955; 2868; 5; 4790; 1922 
1; 956; 2871; 5; 4795; 1924 
1; 957; 2874; 5; 4800; 1926 
1; 958; 2877; 5; 4805; 1928 
1; 959; 2880; 5; 4810; 1930 
1; 960; 2883; 5; 4815; 1932 
1; 961; 2886; 5; 4820; 1934 
1; 962; 2889; 5; 4825; 1936 
1; 963; 2892; 5; 4830; 1938 
1; 964; 2895; 5; 4835; 1940 
1; 965; 2898; 5; 4840; 1942 
1; 966; 2901; 5; 4845; 1944 
1; 967; 2904; 5; 4850; 1946 
1; 968; 2907; 5; 4855; 1948 
1; 969; 2910; 5; 4860; 1950 
1; 970; 2913; 5; 4865; 1952 
1; 971; 2916; 5; 4870; 1954 
1; 972; 2919; 5; 4875; 1956 
1; 973; 2922; 5; 4880; 1958 
1; 974; 2925; 5; 4885; 1960 
1; 975; 2928; 5; 4890; 1962 
1; 976; 2931; 5; 4895; 1964 
1; 977; 2934; 5; 4900; 1966 
1; 978; 2937; 5; 4905; 1968 
1; 979; 2940; 5; 4910; 1970 
1; 980; 2943; 5; 4915; 1972 
1; 981; 2946; 5; 4920; 1974 
1; 982; 2949; 5; 4925; 1976 
1; 983; 2952; 5; 4930; 1978 
1; 984; 2955; 5; 4935; 1980 
1; 985; 2958; 5; 4940; 1982 
1; 986; 2961; 5; 4945; 1984 
1; 987; 2964; 5; 4950; 1986 
1; 988; 2967; 5; 4955; 1988 
1; 989; 2970; 5; 4960; 1990 
1; 990; 2973; 5; 4965; 1992 
1; 991; 2976; 5; 4970; 1994 
1; 992; 2979; 5; 4975; 1996 
1; 993; 2982; 5; 4980; 1998 
1; 994; 2985; 5; 4985; 2000 
1; 995; 2988; 5; 4990; 2002 
1; 996; 2991; 5; 4995; 2004 
1; 997; 2994; 5; 5000; 2006 
1; 998; 2997; 5; 5005; 2008 
1; 999; 3000; 5; 5010; 2010 
1; 1000; 3003; 5; 5015; 2012 
1; 1001; 3006; 5; 5020; 2014 
1; 1002; 3009; 5; 5025; 2016 
1; 1003; 3012; 5; 5030; 2018 
1; 1004; 3015; 5; 5035; 2020 
1; 1005; 3018; 5; 5040; 2022 
1; 1006; 3021; 5; 5045; 2024 
1; 1007; 3024; 5; 5050; 2026 
1; 1008; 3027; 5; 5055; 2028 
1; 1009; 3030; 5; 5060; 2030 
1; 1010; 3033; 5; 5065; 2032 
1; 1011; 3036; 5; 5070; 2034 
1; 1012; 3039; 5; 5075; 2036 
1; 1013; 3042; 5; 5080; 2038 
1; 1014; 3045; 5; 5085; 2040 
1; 1015; 3048; 5; 5090; 2042 
1; 1016; 3051; 5; 5095; 2044 
1; 1017; 3054; 5; 5100; 2046 
1; 1018; 3057; 5; 5105; 2048 
1; 1019; 3060; 5; 5110; 2050 
1; 1020; 3063; 5; 5115; 2052 
1; 1021; 3066; 5; 5120; 2054 
1; 1022; 3069; 5; 5125; 2056 
1; 1023; 3072; 5; 5130; 2058 
1; 1024; 3075; 5; 5135; 2060 
1; 1025; 3078; 5; 5140; 2062 
1; 1026; 3081; 5; 5145; 2064 
1; 1027; 3084; 5; 5150; 2066 
1; 1028; 3087; 5; 5155; 2068 
1; 1029; 3090; 5; 5160; 2070 
1; 1030; 3093; 5; 5165; 2072 
1; 1031; 3096; 5; 5170; 2074 
1; 1032; 3099; 5; 5175; 2076 
1; 1033; 3102; 5; 5180; 2078 
1; 1034; 3105; 5; 5185; 2080 
1; 1035; 3108; 5; 5190; 2082 
1; 1036; 3111; 5; 5195; 2084 
1; 1037; 3114; 5; 5200; 2086 
1; 1038; 3117; 5; 5205; 2088 
1; 1039; 3120; 5; 5210; 2090 
1; 1040; 3123; 5; 5215; 2092 
1; 1041; 3126; 5; 5220; 2094 
1; 1042; 3129; 5; 5225; 2096 
1; 1043; 3132; 5; 5230; 2098 
1; 1044; 3135; 5; 5235; 2100 
1; 1045; 3138; 5; 5240; 2102 
1; 1046; 3141; 5; 5245; 2104 
1; 1047; 3144; 5; 5250; 2106 
1; 1048; 3147; 5; 5255; 2108 
1; 1049; 3150; 5; 5260; 2110 
1; 1050; 3153; 5; 5265; 2112 
1; 1051; 3156; 5; 5270; 2114 
1; 1052; 3159; 5; 5275; 2116 
1; 1053; 3162; 5; 5280; 2118 
1; 1054; 3165; 5; 5285; 2120 
1; 1055; 3168; 5; 5290; 2122 
1; 1056; 3171; 5; 5295; 2124 
1; 1057; 3174; 5; 5300; 2126 
1; 1058; 3177; 5; 5305; 2128 
1; 1059; 3180; 5; 5310; 2130 
1; 1060; 3183; 5; 5315; 2132 
1; 1061; 3186; 5; 5320; 2134 
1; 1062; 3189; 5; 5325; 2136 
1; 1063; 3192; 5; 5330; 2138 
1; 1064; 3195; 5; 5335; 2140 
1; 1065; 3198; 5; 5340; 2142 
1; 1066; 3201; 5; 5345; 2144 
1; 1067; 3204; 5; 5350; 2146 
1; 1068; 3207; 5; 5355; 2148 
1; 1069; 3210; 5; 5360; 2150 
1; 1070; 3213; 5; 5365; 2152 
1; 1071; 3216; 5; 5370; 2154 
1; 1072; 3219; 5; 5375; 2156 
1; 1073; 3222; 5; 5380; 2158 
1; 1074; 3225; 5; 5385; 2160 
1; 1075; 3228; 5; 5390; 2162 
1; 1076; 3231; 5; 5395; 2164 
1; 1077; 3234; 5; 5400; 2166 
1; 1078; 3237; 5; 5405; 2168 
1; 1079; 3240; 5; 5410; 2170 
1; 1080; 3243; 5; 5415; 2172 
1; 1081; 3246; 5; 5420; 2174 
1; 1082; 3249; 5; 5425; 2176 
1; 1083; 3252; 5; 5430; 2178 
1; 1084; 3255; 5; 5435; 2180 
1; 1085; 3258; 5; 5440; 2182 
1; 1086; 3261; 5; 5445; 2184 
1; 1087; 3264; 5; 5450; 2186 
1; 1088; 3267; 5; 5455; 2188 
1; 1089; 3270; 5; 5460; 2190 
1; 1090; 3273; 5; 5465; 2192 
1; 1091; 3276; 5; 5470; 2194 
1; 1092; 3279; 5; 5475; 2196 
1; 1093; 3282; 5; 5480; 2198 
1; 1094; 3285; 5; 5485; 2200 
1; 1095; 3288; 5; 5490; 2202 
1; 1096; 3291; 5; 5495; 2204 
1; 1097; 3294; 5; 5500; 2206 
1; 1098; 3297; 5; 5505; 2208 
1; 1099; 3300; 5; 5510; 2210 
1; 1100; 3303; 5; 5515; 2212 
1; 1101; 3306; 5; 5520; 2214 
1; 1102; 3309; 5; 5525; 2216 
1; 1103; 3312; 5; 5530; 2218 
1; 1104; 3315; 5; 5535; 2220 
1; 1105; 3318; 5; 5540; 2222 
1; 1106; 3321; 5; 5545; 2224 
1; 1107; 3324; 5; 5550; 2226 
1; 1108; 3327; 5; 5555; 2228 
1; 1109; 3330; 5; 5560; 2230 
1; 1110; 3333; 5; 5565; 2232 
1; 1111; 3336; 5; 5570; 2234 
1; 1112; 3339; 5; 5575; 2236 
1; 1113; 3342; 5; 5580; 2238 
1; 1114; 3345; 5; 5585; 2240 
1; 1115; 3348; 5; 5590; 2242 
1; 1116; 3351; 5; 5595; 2244 
1; 1117; 3354; 5; 5600; 2246 
1; 1118; 3357; 5; 5605; 2248 
1; 1119; 3360; 5; 5610; 2250 
1; 1120; 3363; 5; 5615; 2252 
1; 1121; 3366; 5; 5620; 2254 
1; 1122; 3369; 5; 5625; 2256 
1; 1123; 3372; 5; 5630; 2258 
1; 1124; 3375; 5; 5635; 2260 
1; 1125; 3378; 5; 5640; 2262 
1; 1126; 3381; 5; 5645; 2264 
1; 1127; 3384; 5; 5650; 2266 
1; 1128; 3387; 5; 5655; 2268 
1; 1129; 3390; 5; 5660; 2270 
1; 1130; 3393; 5; 5665; 2272 
1; 1131; 3396; 5; 5670; 2274 
1; 1132; 3399; 5; 5675; 2276 
1; 1133; 3402; 5; 5680; 2278 
1; 1134; 3405; 5; 5685; 2280 
1; 1135; 3408; 5; 5690; 2282 
1; 1136; 3411; 5; 5695; 2284 
1; 1137; 3414; 5; 5700; 2286 
1; 1138; 3417; 5; 5705; 2288 
1; 1139; 3420; 5; 5710; 2290 
1; 1140; 3423; 5; 5715; 2292 
1; 1141; 3426; 5; 5720; 2294 
1; 1142; 3429; 5; 5725; 2296 
1; 1143; 3432; 5; 5730; 2298 
1; 1144; 3435; 5; 5735; 2300 
1; 1145; 3438; 5; 5740; 2302 
1; 1146; 3441; 5; 5745; 2304 
1; 1147; 3444; 5; 5750; 2306 
1; 1148; 3447; 5; 5755; 2308 
1; 1149; 3450; 5; 5760; 2310 
1; 1150; 3453; 5; 5765; 2312 
1; 1151; 3456; 5; 5770; 2314 
1; 1152; 3459; 5; 5775; 2316 
1; 1153; 3462; 5; 5780; 2318 
1; 1154; 3465; 5; 5785; 2320 
1; 1155; 3468; 5; 5790; 2322 
1; 1156; 3471; 5; 5795; 2324 
1; 1157; 3474; 5; 5800; 2326 
1; 1158; 3477; 5; 5805; 2328 
1; 1159; 3480; 5; 5810; 2330 
1; 1160; 3483; 5; 5815; 2332 
1; 1161; 3486; 5; 5820; 2334 
1; 1162; 3489; 5; 5825; 2336 
1; 1163; 3492; 5; 5830; 2338 
1; 1164; 3495; 5; 5835; 2340 
1; 1165; 3498; 5; 5840; 2342 
1; 1166; 3501; 5; 5845; 2344 
1; 1167; 3504; 5; 5850; 2346 
1; 1168; 3507; 5; 5855; 2348 
1; 1169; 3510; 5; 5860; 2350 
1; 1170; 3513; 5; 5865; 2352 
1; 1171; 3516; 5; 5870; 2354 
1; 1172; 3519; 5; 5875; 2356 
1; 1173; 3522; 5; 5880; 2358 
1; 1174; 3525; 5; 5885; 2360 
1; 1175; 3528; 5; 5890; 2362 
1; 1176; 3531; 5; 5895; 2364 
1; 1177; 3534; 5; 5900; 2366 
1; 1178; 3537; 5; 5905; 2368 
1; 1179; 3540; 5; 5910; 2370 
1; 1180; 3543; 5; 5915; 2372 
1; 1181; 3546; 5; 5920; 2374 
1; 1182; 3549; 5; 5925; 2376 
1; 1183; 3552; 5; 5930; 2378 
1; 1184; 3555; 5; 5935; 2380 
1; 1185; 3558; 5; 5940; 2382 
1; 1186; 3561; 5; 5945; 2384 
1; 1187; 3564; 5; 5950; 2386 
1; 1188; 3567; 5; 5955; 2388 
1; 1189; 3570; 5; 5960; 2390 
1; 1190; 3573; 5; 5965; 2392 
1; 1191; 3576; 5; 5970; 2394 
1; 1192; 3579; 5; 5975; 2396 
1; 1193; 3582; 5; 5980; 2398 
1; 1194; 3585; 5; 5985; 2400 
1; 1195; 3588; 5; 5990; 2402 
1; 1196; 3591; 5; 5995; 2404 
1; 1197; 3594; 5; 6000; 2406 
1; 1198; 3597; 5; 6005; 2408 
1; 1199; 3600; 5; 6010; 2410 
1; 1200; 3603; 5; 6015; 2412 
1; 1201; 3606; 5; 6020; 2414 
1; 1202; 3609; 5; 6025; 2416 
1; 1203; 3612; 5; 6030; 2418 
1; 1204; 3615; 5; 6035; 2420 
1; 1205; 3618; 5; 6040; 2422 
1; 1206; 3621; 5; 6045; 2424 
1; 1207; 3624; 5; 6050; 2426 
1; 1208; 3627; 5; 6055; 2428 
1; 1209; 3630; 5; 6060; 2430 
1; 1210; 3633; 5; 6065; 2432 
1; 1211; 3636; 5; 6070; 2434 
1; 1212; 3639; 5; 6075; 2436 
1; 1213; 3642; 5; 6080; 2438 
1; 1214; 3645; 5; 6085; 2440 
1; 1215; 3648; 5; 6090; 2442 
1; 1216; 3651; 5; 6095; 2444 
1; 1217; 3654; 5; 6100; 2446 
1; 1218; 3657; 5; 6105; 2448 
1; 1219; 3660; 5; 6110; 2450 
1; 1220; 3663; 5; 6115; 2452 
1; 1221; 3666; 5; 6120; 2454 
1; 1222; 3669; 5; 6125; 2456 
1; 1223; 3672; 5; 6130; 2458 
1; 1224; 3675; 5; 6135; 2460 
1; 1225; 3678; 5; 6140; 2462 
1; 1226; 3681; 5; 6145; 2464 
1; 1227; 3684; 5; 6150; 2466 
1; 1228; 3687; 5; 6155; 2468 
1; 1229; 3690; 5; 6160; 2470 
1; 1230; 3693; 5; 6165; 2472 
1; 1231; 3696; 5; 6170; 2474 
1; 1232; 3699; 5; 6175; 2476 
1; 1233; 3702; 5; 6180; 2478 
1; 1234; 3705; 5; 6185; 2480 
1; 1235; 3708; 5; 6190; 2482 
1; 1236; 3711; 5; 6195; 2484 
1; 1237; 3714; 5; 6200; 2486 
1; 1238; 3717; 5; 6205; 2488 
1; 1239; 3720; 5; 6210; 2490 
1; 1240; 3723; 5; 6215; 2492 
1; 1241; 3726; 5; 6220; 2494 
1; 1242; 3729; 5; 6225; 2496 
1; 1243; 3732; 5; 6230; 2498 
1; 1244; 3735; 5; 6235; 2500 
1; 1245; 3738; 5; 6240; 2502 
1; 1246; 3741; 5; 6245; 2504 
1; 1247; 3744; 5; 6250; 2506 
1; 1248; 3747; 5; 6255; 2508 
1; 1249; 3750; 5; 6260; 2510 
1; 1250; 3753; 5; 6265; 2512 
1; 1251; 3756; 5; 6270; 2514 
1; 1252; 3759; 5; 6275; 2516 
1; 1253; 3762; 5; 6280; 2518 
1; 1254; 3765; 5; 6285; 2520 
1; 1255; 3768; 5; 6290; 2522 
1; 1256; 3771; 5; 6295; 2524 
1; 1257; 3774; 5; 6300; 2526 
1; 1258; 3777; 5; 6305; 2528 
1; 1259; 3780; 5; 6310; 2530 
1; 1260; 3783; 5; 6315; 2532 
1; 1261; 3786; 5; 6320; 2534 
1; 1262; 3789; 5; 6325; 2536 
1; 1263; 3792; 5; 6330; 2538 
1; 1264; 3795; 5; 6335; 2540 
1; 1265; 3798; 5; 6340; 2542 
1; 1266; 3801; 5; 6345; 2544 
1; 1267; 3804; 5; 6350; 2546 
1; 1268; 3807; 5; 6355; 2548 
1; 1269; 3810; 5; 6360; 2550 
1; 1270; 3813; 5; 6365; 2552 
1; 1271; 3816; 5; 6370; 2554 
1; 1272; 3819; 5; 6375; 2556 
1; 1273; 3822; 5; 6380; 2558 
1; 1274; 3825; 5; 6385; 2560 
1; 1275; 3828; 5; 6390; 2562 
1; 1276; 3831; 5; 6395; 2564 
1; 1277; 3834; 5; 6400; 2566 
1; 1278; 3837; 5; 6405; 2568 
1; 1279; 3840; 5; 6410; 2570 
1; 1280; 3843; 5; 6415; 2572 
1; 1281; 3846; 5; 6420; 2574 
1; 1282; 3849; 5; 6425; 2576 
1; 1283; 3852; 5; 6430; 2578 
1; 1284; 3855; 5; 6435; 2580 
1; 1285; 3858; 5; 6440; 2582 
1; 1286; 3861; 5; 6445; 2584 
1; 1287; 3864; 5; 6450; 2586 
1; 1288; 3867; 5; 6455; 2588 
1; 1289; 3870; 5; 6460; 2590 
1; 1290; 3873; 5; 6465; 2592 
1; 1291; 3876; 5; 6470; 2594 
1; 1292; 3879; 5; 6475; 2596 
1; 1293; 3882; 5; 6480; 2598 
1; 1294; 3885; 5; 6485; 2600 
1; 1295; 3888; 5; 6490; 2602 
1; 1296; 3891; 5; 6495; 2604 
1; 1297; 3894; 5; 6500; 2606 
1; 1298; 3897; 5; 6505; 2608 
1; 1299; 3900; 5; 6510; 2610 
1; 1300; 3903; 5; 6515; 2612 
1; 1301; 3906; 5; 6520; 2614 
1; 1302; 3909; 5; 6525; 2616 
1; 1303; 3912; 5; 6530; 2618 
1; 1304; 3915; 5; 6535; 2620 
1; 1305; 3918; 5; 6540; 2622 
1; 1306; 3921; 5; 6545; 2624 
1; 1307; 3924; 5; 6550; 2626 
1; 1308; 3927; 5; 6555; 2628 
1; 1309; 3930; 5; 6560; 2630 
1; 1310; 3933; 5; 6565; 2632 
1; 1311; 3936; 5; 6570; 2634 
1; 1312; 3939; 5; 6575; 2636 
1; 1313; 3942; 5; 6580; 2638 
1; 1314; 3945; 5; 6585; 2640 
1; 1315; 3948; 5; 6590; 2642 
1; 1316; 3951; 5; 6595; 2644 
1; 1317; 3954; 5; 6600; 2646 
1; 1318; 3957; 5; 6605; 2648 
1; 1319; 3960; 5; 6610; 2650 
1; 1320; 3963; 5; 6615; 2652 
1; 1321; 3966; 5; 6620; 2654 
1; 1322; 3969; 5; 6625; 2656 
1; 1323; 3972; 5; 6630; 2658 
1; 1324; 3975; 5; 6635; 2660 
1; 1325; 3978; 5; 6640; 2662 
1; 1326; 3981; 5; 6645; 2664 
1; 1327; 3984; 5; 6650; 2666 
1; 1328; 3987; 5; 6655; 2668 
1; 1329; 3990; 5; 6660; 2670 
1; 1330; 3993; 5; 6665; 2672 
1; 1331; 3996; 5; 6670; 2674 
1; 1332; 3999; 5; 6675; 2676 
1; 1333; 4002; 5; 6680; 2678 
1; 1334; 4005; 5; 6685; 2680 
1; 1335; 4008; 5; 6690; 2682 
1; 1336; 4011; 5; 6695; 2684 
1; 1337; 4014; 5; 6700; 2686 
1; 1338; 4017; 5; 6705; 2688 
1; 1339; 4020; 5; 6710; 2690 
1; 1340; 4023; 5; 6715; 2692 
1; 1341; 4026; 5; 6720; 2694 
1; 1342; 4029; 5; 6725; 2696 
1; 1343; 4032; 5; 6730; 2698 
1; 1344; 4035; 5; 6735; 2700 
1; 1345; 4038; 5; 6740; 2702 
1; 1346; 4041; 5; 6745; 2704 
1; 1347; 4044; 5; 6750; 2706 
1; 1348; 4047; 5; 6755; 2708 
1; 1349; 4050; 5; 6760; 2710 
1; 1350; 4053; 5; 6765; 2712 
1; 1351; 4056; 5; 6770; 2714 
1; 1352; 4059; 5; 6775; 2716 
1; 1353; 4062; 5; 6780; 2718 
1; 1354; 4065; 5; 6785; 2720 
1; 1355; 4068; 5; 6790; 2722 
1; 1356; 4071; 5; 6795; 2724 
1; 1357; 4074; 5; 6800; 2726 
1; 1358; 4077; 5; 6805; 2728 
1; 1359; 4080; 5; 6810; 2730 
1; 1360; 4083; 5; 6815; 2732 
1; 1361; 4086; 5; 6820; 2734 
1; 1362; 4089; 5; 6825; 2736 
1; 1363; 4092; 5; 6830; 2738 
1; 1364; 4095; 5; 6835; 2740 
1; 1365; 4098; 5; 6840; 2742 
1; 1366; 4101; 5; 6845; 2744 
1; 1367; 4104; 5; 6850; 2746 
1; 1368; 4107; 5; 6855; 2748 
1; 1369; 4110; 5; 6860; 2750 
1; 1370; 4113; 5; 6865; 2752 
1; 1371; 4116; 5; 6870; 2754 
1; 1372; 4119; 5; 6875; 2756 
1; 1373; 4122; 5; 6880; 2758 
1; 1374; 4125; 5; 6885; 2760 
1; 1375; 4128; 5; 6890; 2762 
1; 1376; 4131; 5; 6895; 2764 
1; 1377; 4134; 5; 6900; 2766 
1; 1378; 4137; 5; 6905; 2768 
1; 1379; 4140; 5; 6910; 2770 
1; 1380; 4143; 5; 6915; 2772 
1; 1381; 4146; 5; 6920; 2774 
1; 1382; 4149; 5; 6925; 2776 
1; 1383; 4152; 5; 6930; 2778 
1; 1384; 4155; 5; 6935; 2780 
1; 1385; 4158; 5; 6940; 2782 
1; 1386; 4161; 5; 6945; 2784 
1; 1387; 4164; 5; 6950; 2786 
1; 1388; 4167; 5; 6955; 2788 
1; 1389; 4170; 5; 6960; 2790 
1; 1390; 4173; 5; 6965; 2792 
1; 1391; 4176; 5; 6970; 2794 
1; 1392; 4179; 5; 6975; 2796 
1; 1393; 4182; 5; 6980; 2798 
1; 1394; 4185; 5; 6985; 2800 
1; 1395; 4188; 5; 6990; 2802 
1; 1396; 4191; 5; 6995; 2804 
1; 1397; 4194; 5; 7000; 2806 
1; 1398; 4197; 5; 7005; 2808 
1; 1399; 4200; 5; 7010; 2810 
1; 1400; 4203; 5; 7015; 2812 
1; 1401; 4206; 5; 7020; 2814 
1; 1402; 4209; 5; 7025; 2816 
1; 1403; 4212; 5; 7030; 2818 
1; 1404; 4215; 5; 7035; 2820 
1; 1405; 4218; 5; 7040; 2822 
1; 1406; 4221; 5; 7045; 2824 
1; 1407; 4224; 5; 7050; 2826 
1; 1408; 4227; 5; 7055; 2828 
1; 1409; 4230; 5; 7060; 2830 
1; 1410; 4233; 5; 7065; 2832 
1; 1411; 4236; 5; 7070; 2834 
1; 1412; 4239; 5; 7075; 2836 
1; 1413; 4242; 5; 7080; 2838 
1; 1414; 4245; 5; 7085; 2840 
1; 1415; 4248; 5; 7090; 2842 
1; 1416; 4251; 5; 7095; 2844 
1; 1417; 4254; 5; 7100; 2846 
1; 1418; 4257; 5; 7105; 2848 
1; 1419; 4260; 5; 7110; 2850 
1; 1420; 4263; 5; 7115; 2852 
1; 1421; 4266; 5; 7120; 2854 
1; 1422; 4269; 5; 7125; 2856 
1; 1423; 4272; 5; 7130; 2858 
1; 1424; 4275; 5; 7135; 2860 
1; 1425; 4278; 5; 7140; 2862 
1; 1426; 4281; 5; 7145; 2864 
1; 1427; 4284; 5; 7150; 2866 
1; 1428; 4287; 5; 7155; 2868 
1; 1429; 4290; 5; 7160; 2870 
1; 1430; 4293; 5; 7165; 2872 
1; 1431; 4296; 5; 7170; 2874 
1; 1432; 4299; 5; 7175; 2876 
1; 1433; 4302; 5; 7180; 2878 
1; 1434; 4305; 5; 7185; 2880 
1; 1435; 4308; 5; 7190; 2882 
1; 1436; 4311; 5; 7195; 2884 
1; 1437; 4314; 5; 7200; 2886 
1; 1438; 4317; 5; 7205; 2888 
1; 1439; 4320; 5; 7210; 2890 
1; 1440; 4323; 5; 7215; 2892 
1; 1441; 4326; 5; 7220; 2894 
1; 1442; 4329; 5; 7225; 2896 
1; 1443; 4332; 5; 7230; 2898 
1; 1444; 4335; 5; 7235; 2900 
1; 1445; 4338; 5; 7240; 2902 
1; 1446; 4341; 5; 7245; 2904 
1; 1447; 4344; 5; 7250; 2906 
1; 1448; 4347; 5; 7255; 2908 
1; 1449; 4350; 5; 7260; 2910 
1; 1450; 4353; 5; 7265; 2912 
1; 1451; 4356; 5; 7270; 2914 
1; 1452; 4359; 5; 7275; 2916 
1; 1453; 4362; 5; 7280; 2918 
1; 1454; 4365; 5; 7285; 2920 
1; 1455; 4368; 5; 7290; 2922 
1; 1456; 4371; 5; 7295; 2924 
1; 1457; 4374; 5; 7300; 2926 
1; 1458; 4377; 5; 7305; 2928 
1; 1459; 4380; 5; 7310; 2930 
1; 1460; 4383; 5; 7315; 2932 
1; 1461; 4386; 5; 7320; 2934 
1; 1462; 4389; 5; 7325; 2936 
1; 1463; 4392; 5; 7330; 2938 
1; 1464; 4395; 5; 7335; 2940 
1; 1465; 4398; 5; 7340; 2942 
1; 1466; 4401; 5; 7345; 2944 
1; 1467; 4404; 5; 7350; 2946 
1; 1468; 4407; 5; 7355; 2948 
1; 1469; 4410; 5; 7360; 2950 
1; 1470; 4413; 5; 7365; 2952 
1; 1471; 4416; 5; 7370; 2954 
1; 1472; 4419; 5; 7375; 2956 
1; 1473; 4422; 5; 7380; 2958 
1; 1474; 4425; 5; 7385; 2960 
1; 1475; 4428; 5; 7390; 2962 
1; 1476; 4431; 5; 7395; 2964 
1; 1477; 4434; 5; 7400; 2966 
1; 1478; 4437; 5; 7405; 2968 
1; 1479; 4440; 5; 7410; 2970 
1; 1480; 4443; 5; 7415; 2972 
1; 1481; 4446; 5; 7420; 2974 
1; 1482; 4449; 5; 7425; 2976 
1; 1483; 4452; 5; 7430; 2978 
1; 1484; 4455; 5; 7435; 2980 
1; 1485; 4458; 5; 7440; 2982 
1; 1486; 4461; 5; 7445; 2984 
1; 1487; 4464; 5; 7450; 2986 
1; 1488; 4467; 5; 7455; 2988 
1; 1489; 4470; 5; 7460; 2990 
1; 1490; 4473; 5; 7465; 2992 
1; 1491; 4476; 5; 7470; 2994 
1; 1492; 4479; 5; 7475; 2996 
1; 1493; 4482; 5; 7480; 2998 
1; 1494; 4485; 5; 7485; 3000 
1; 1495; 4488; 5; 7490; 3002 
1; 1496; 4491; 5; 7495; 3004 
1; 1497; 4494; 5; 7500; 3006 
1; 1498; 4497; 5; 7505; 3008 
1; 1499; 4500; 5; 7510; 3010 
1; 1500; 4503; 5; 7515; 3012 
1; 1501; 4506; 5; 7520; 3014 
1; 1502; 4509; 5; 7525; 3016 
1; 1503; 4512; 5; 7530; 3018 
1; 1504; 4515; 5; 7535; 3020 
1; 1505; 4518; 5; 7540; 3022 
1; 1506; 4521; 5; 7545; 3024 
1; 1507; 4524; 5; 7550; 3026 
1; 1508; 4527; 5; 7555; 3028 
1; 1509; 4530; 5; 7560; 3030 
1; 1510; 4533; 5; 7565; 3032 
1; 1511; 4536; 5; 7570; 3034 
1; 1512; 4539; 5; 7575; 3036 
1; 1513; 4542; 5; 7580; 3038 
1; 1514; 4545; 5; 7585; 3040 
1; 1515; 4548; 5; 7590; 3042 
1; 1516; 4551; 5; 7595; 3044 
1; 1517; 4554; 5; 7600; 3046 
1; 1518; 4557; 5; 7605; 3048 
1; 1519; 4560; 5; 7610; 3050 
1; 1520; 4563; 5; 7615; 3052 
1; 1521; 4566; 5; 7620; 3054 
1; 1522; 4569; 5; 7625; 3056 
1; 1523; 4572; 5; 7630; 3058 
1; 1524; 4575; 5; 7635; 3060 
1; 1525; 4578; 5; 7640; 3062 
1; 1526; 4581; 5; 7645; 3064 
1; 1527; 4584; 5; 7650; 3066 
1; 1528; 4587; 5; 7655; 3068 
1; 1529; 4590; 5; 7660; 3070 
1; 1530; 4593; 5; 7665; 3072 
1; 1531; 4596; 5; 7670; 3074 
1; 1532; 4599; 5; 7675; 3076 
1; 1533; 4602; 5; 7680; 3078 
1; 1534; 4605; 5; 7685; 3080 
1; 1535; 4608; 5; 7690; 3082 
1; 1536; 4611; 5; 7695; 3084 
1; 1537; 4614; 5; 7700; 3086 
1; 1538; 4617; 5; 7705; 3088 
1; 1539; 4620; 5; 7710; 3090 
1; 1540; 4623; 5; 7715; 3092 
1; 1541; 4626; 5; 7720; 3094 
1; 1542; 4629; 5; 7725; 3096 
1; 1543; 4632; 5; 7730; 3098 
1; 1544; 4635; 5; 7735; 3100 
1; 1545; 4638; 5; 7740; 3102 
1; 1546; 4641; 5; 7745; 3104 
1; 1547; 4644; 5; 7750; 3106 
1; 1548; 4647; 5; 7755; 3108 
1; 1549; 4650; 5; 7760; 3110 
1; 1550; 4653; 5; 7765; 3112 
1; 1551; 4656; 5; 7770; 3114 
1; 1552; 4659; 5; 7775; 3116 
1; 1553; 4662; 5; 7780; 3118 
1; 1554; 4665; 5; 7785; 3120 
1; 1555; 4668; 5; 7790; 3122 
1; 1556; 4671; 5; 7795; 3124 
1; 1557; 4674; 5; 7800; 3126 
1; 1558; 4677; 5; 7805; 3128 
1; 1559; 4680; 5; 7810; 3130 
1; 1560; 4683; 5; 7815; 3132 
1; 1561; 4686; 5; 7820; 3134 
1; 1562; 4689; 5; 7825; 3136 
1; 1563; 4692; 5; 7830; 3138 
1; 1564; 4695; 5; 7835; 3140 
1; 1565; 4698; 5; 7840; 3142 
1; 1566; 4701; 5; 7845; 3144 
1; 1567; 4704; 5; 7850; 3146 
1; 1568; 4707; 5; 7855; 3148 
1; 1569; 4710; 5; 7860; 3150 
1; 1570; 4713; 5; 7865; 3152 
1; 1571; 4716; 5; 7870; 3154 
1; 1572; 4719; 5; 7875; 3156 
1; 1573; 4722; 5; 7880; 3158 
1; 1574; 4725; 5; 7885; 3160 
1; 1575; 4728; 5; 7890; 3162 
1; 1576; 4731; 5; 7895; 3164 
1; 1577; 4734; 5; 7900; 3166 
1; 1578; 4737; 5; 7905; 3168 
1; 1579; 4740; 5; 7910; 3170 
1; 1580; 4743; 5; 7915; 3172 
1; 1581; 4746; 5; 7920; 3174 
1; 1582; 4749; 5; 7925; 3176 
1; 1583; 4752; 5; 7930; 3178 
1; 1584; 4755; 5; 7935; 3180 
1; 1585; 4758; 5; 7940; 3182 
1; 1586; 4761; 5; 7945; 3184 
1; 1587; 4764; 5; 7950; 3186 
1; 1588; 4767; 5; 7955; 3188 
1; 1589; 4770; 5; 7960; 3190 
1; 1590; 4773; 5; 7965; 3192 
1; 1591; 4776; 5; 7970; 3194 
1; 1592; 4779; 5; 7975; 3196 
1; 1593; 4782; 5; 7980; 3198 
1; 1594; 4785; 5; 7985; 3200 
1; 1595; 4788; 5; 7990; 3202 
1; 1596; 4791; 5; 7995; 3204 
1; 1597; 4794; 5; 8000; 3206 
1; 1598; 4797; 5; 8005; 3208 
1; 1599; 4800; 5; 8010; 3210 
1; 1600; 4803; 5; 8015; 3212 
1; 1601; 4806; 5; 8020; 3214 
1; 1602; 4809; 5; 8025; 3216 
1; 1603; 4812; 5; 8030; 3218 
1; 1604; 4815; 5; 8035; 3220 
1; 1605; 4818; 5; 8040; 3222 
1; 1606; 4821; 5; 8045; 3224 
1; 1607; 4824; 5; 8050; 3226 
1; 1608; 4827; 5; 8055; 3228 
1; 1609; 4830; 5; 8060; 3230 
1; 1610; 4833; 5; 8065; 3232 
1; 1611; 4836; 5; 8070; 3234 
1; 1612; 4839; 5; 8075; 3236 
1; 1613; 4842; 5; 8080; 3238 
1; 1614; 4845; 5; 8085; 3240 
1; 1615; 4848; 5; 8090; 3242 
1; 1616; 4851; 5; 8095; 3244 
1; 1617; 4854; 5; 8100; 3246 
1; 1618; 4857; 5; 8105; 3248 
1; 1619; 4860; 5; 8110; 3250 
1; 1620; 4863; 5; 8115; 3252 
1; 1621; 4866; 5; 8120; 3254 
1; 1622; 4869; 5; 8125; 3256 
1; 1623; 4872; 5; 8130; 3258 
1; 1624; 4875; 5; 8135; 3260 
1; 1625; 4878; 5; 8140; 3262 
1; 1626; 4881; 5; 8145; 3264 
1; 1627; 4884; 5; 8150; 3266 
1; 1628; 4887; 5; 8155; 3268 
1; 1629; 4890; 5; 8160; 3270 
1; 1630; 4893; 5; 8165; 3272 
1; 1631; 4896; 5; 8170; 3274 
1; 1632; 4899; 5; 8175; 3276 
1; 1633; 4902; 5; 8180; 3278 
1; 1634; 4905; 5; 8185; 3280 
1; 1635; 4908; 5; 8190; 3282 
1; 1636; 4911; 5; 8195; 3284 
1; 1637; 4914; 5; 8200; 3286 
1; 1638; 4917; 5; 8205; 3288 
1; 1639; 4920; 5; 8210; 3290 
1; 1640; 4923; 5; 8215; 3292 
1; 1641; 4926; 5; 8220; 3294 
1; 1642; 4929; 5; 8225; 3296 
1; 1643; 4932; 5; 8230; 3298 
1; 1644; 4935; 5; 8235; 3300 
1; 1645; 4938; 5; 8240; 3302 
1; 1646; 4941; 5; 8245; 3304 
1; 1647; 4944; 5; 8250; 3306 
1; 1648; 4947; 5; 8255; 3308 
1; 1649; 4950; 5; 8260; 3310 
1; 1650; 4953; 5; 8265; 3312 
1; 1651; 4956; 5; 8270; 3314 
1; 1652; 4959; 5; 8275; 3316 
1; 1653; 4962; 5; 8280; 3318 
1; 1654; 4965; 5; 8285; 3320 
1; 1655; 4968; 5; 8290; 3322 
1; 1656; 4971; 5; 8295; 3324 
1; 1657; 4974; 5; 8300; 3326 
1; 1658; 4977; 5; 8305; 3328 
1; 1659; 4980; 5; 8310; 3330 
1; 1660; 4983; 5; 8315; 3332 
1; 1661; 4986; 5; 8320; 3334 
1; 1662; 4989; 5; 8325; 3336 
1; 1663; 4992; 5; 8330; 3338 
1; 1664; 4995; 5; 8335; 3340 
1; 1665; 4998; 5; 8340; 3342 
1; 1666; 5001; 5; 8345; 3344 
1; 1667; 5004; 5; 8350; 3346 
1; 1668; 5007; 5; 8355; 3348 
1; 1669; 5010; 5; 8360; 3350 
1; 1670; 5013; 5; 8365; 3352 
1; 1671; 5016; 5; 8370; 3354 
1; 1672; 5019; 5; 8375; 3356 
1; 1673; 5022; 5; 8380; 3358 
1; 1674; 5025; 5; 8385; 3360 
1; 1675; 5028; 5; 8390; 3362 
1; 1676; 5031; 5; 8395; 3364 
1; 1677; 5034; 5; 8400; 3366 
1; 1678; 5037; 5; 8405; 3368 
1; 1679; 5040; 5; 8410; 3370 
1; 1680; 5043; 5; 8415; 3372 
1; 1681; 5046; 5; 8420; 3374 
1; 1682; 5049; 5; 8425; 3376 
1; 1683; 5052; 5; 8430; 3378 
1; 1684; 5055; 5; 8435; 3380 
1; 1685; 5058; 5; 8440; 3382 
1; 1686; 5061; 5; 8445; 3384 
1; 1687; 5064; 5; 8450; 3386 
1; 1688; 5067; 5; 8455; 3388 
1; 1689; 5070; 5; 8460; 3390 
1; 1690; 5073; 5; 8465; 3392 
1; 1691; 5076; 5; 8470; 3394 
1; 1692; 5079; 5; 8475; 3396 
1; 1693; 5082; 5; 8480; 3398 
1; 1694; 5085; 5; 8485; 3400 
1; 1695; 5088; 5; 8490; 3402 
1; 1696; 5091; 5; 8495; 3404 
1; 1697; 5094; 5; 8500; 3406 
1; 1698; 5097; 5; 8505; 3408 
1; 1699; 5100; 5; 8510; 3410 
1; 1700; 5103; 5; 8515; 3412 
1; 1701; 5106; 5; 8520; 3414 
1; 1702; 5109; 5; 8525; 3416 
1; 1703; 5112; 5; 8530; 3418 
1; 1704; 5115; 5; 8535; 3420 
1; 1705; 5118; 5; 8540; 3422 
1; 1706; 5121; 5; 8545; 3424 
1; 1707; 5124; 5; 8550; 3426 
1; 1708; 5127; 5; 8555; 3428 
1; 1709; 5130; 5; 8560; 3430 
1; 1710; 5133; 5; 8565; 3432 
1; 1711; 5136; 5; 8570; 3434 
1; 1712; 5139; 5; 8575; 3436 
1; 1713; 5142; 5; 8580; 3438 
1; 1714; 5145; 5; 8585; 3440 
1; 1715; 5148; 5; 8590; 3442 
1; 1716; 5151; 5; 8595; 3444 
1; 1717; 5154; 5; 8600; 3446 
1; 1718; 5157; 5; 8605; 3448 
1; 1719; 5160; 5; 8610; 3450 
1; 1720; 5163; 5; 8615; 3452 
1; 1721; 5166; 5; 8620; 3454 
1; 1722; 5169; 5; 8625; 3456 
1; 1723; 5172; 5; 8630; 3458 
1; 1724; 5175; 5; 8635; 3460 
1; 1725; 5178; 5; 8640; 3462 
1; 1726; 5181; 5; 8645; 3464 
1; 1727; 5184; 5; 8650; 3466 
1; 1728; 5187; 5; 8655; 3468 
1; 1729; 5190; 5; 8660; 3470 
1; 1730; 5193; 5; 8665; 3472 
1; 1731; 5196; 5; 8670; 3474 
1; 1732; 5199; 5; 8675; 3476 
1; 1733; 5202; 5; 8680; 3478 
1; 1734; 5205; 5; 8685; 3480 
1; 1735; 5208; 5; 8690; 3482 
1; 1736; 5211; 5; 8695; 3484 
1; 1737; 5214; 5; 8700; 3486 
1; 1738; 5217; 5; 8705; 3488 
1; 1739; 5220; 5; 8710; 3490 
1; 1740; 5223; 5; 8715; 3492 
1; 1741; 5226; 5; 8720; 3494 
1; 1742; 5229; 5; 8725; 3496 
1; 1743; 5232; 5; 8730; 3498 
1; 1744; 5235; 5; 8735; 3500 
1; 1745; 5238; 5; 8740; 3502 
1; 1746; 5241; 5; 8745; 3504 
1; 1747; 5244; 5; 8750; 3506 
1; 1748; 5247; 5; 8755; 3508 
1; 1749; 5250; 5; 8760; 3510 
1; 1750; 5253; 5; 8765; 3512 
1; 1751; 5256; 5; 8770; 3514 
1; 1752; 5259; 5; 8775; 3516 
1; 1753; 5262; 5; 8780; 3518 
1; 1754; 5265; 5; 8785; 3520 
1; 1755; 5268; 5; 8790; 3522 
1; 1756; 5271; 5; 8795; 3524 
1; 1757; 5274; 5; 8800; 3526 
1; 1758; 5277; 5; 8805; 3528 
1; 1759; 5280; 5; 8810; 3530 
1; 1760; 5283; 5; 8815; 3532 
1; 1761; 5286; 5; 8820; 3534 
1; 1762; 5289; 5; 8825; 3536 
1; 1763; 5292; 5; 8830; 3538 
1; 1764; 5295; 5; 8835; 3540 
1; 1765; 5298; 5; 8840; 3542 
1; 1766; 5301; 5; 8845; 3544 
1; 1767; 5304; 5; 8850; 3546 
1; 1768; 5307; 5; 8855; 3548 
1; 1769; 5310; 5; 8860; 3550 
1; 1770; 5313; 5; 8865; 3552 
1; 1771; 5316; 5; 8870; 3554 
1; 1772; 5319; 5; 8875; 3556 
1; 1773; 5322; 5; 8880; 3558 
1; 1774; 5325; 5; 8885; 3560 
1; 1775; 5328; 5; 8890; 3562 
1; 1776; 5331; 5; 8895; 3564 
1; 1777; 5334; 5; 8900; 3566 
1; 1778; 5337; 5; 8905; 3568 
1; 1779; 5340; 5; 8910; 3570 
1; 1780; 5343; 5; 8915; 3572 
1; 1781; 5346; 5; 8920; 3574 
1; 1782; 5349; 5; 8925; 3576 
1; 1783; 5352; 5; 8930; 3578 
1; 1784; 5355; 5; 8935; 3580 
1; 1785; 5358; 5; 8940; 3582 
1; 1786; 5361; 5; 8945; 3584 
1; 1787; 5364; 5; 8950; 3586 
1; 1788; 5367; 5; 8955; 3588 
1; 1789; 5370; 5; 8960; 3590 
1; 1790; 5373; 5; 8965; 3592 
1; 1791; 5376; 5; 8970; 3594 
1; 1792; 5379; 5; 8975; 3596 
1; 1793; 5382; 5; 8980; 3598 
1; 1794; 5385; 5; 8985; 3600 
1; 1795; 5388; 5; 8990; 3602 
1; 1796; 5391; 5; 8995; 3604 
1; 1797; 5394; 5; 9000; 3606 
1; 1798; 5397; 5; 9005; 3608 
1; 1799; 5400; 5; 9010; 3610 
1; 1800; 5403; 5; 9015; 3612 
1; 1801; 5406; 5; 9020; 3614 
1; 1802; 5409; 5; 9025; 3616 
1; 1803; 5412; 5; 9030; 3618 
1; 1804; 5415; 5; 9035; 3620 
1; 1805; 5418; 5; 9040; 3622 
1; 1806; 5421; 5; 9045; 3624 
1; 1807; 5424; 5; 9050; 3626 
1; 1808; 5427; 5; 9055; 3628 
1; 1809; 5430; 5; 9060; 3630 
1; 1810; 5433; 5; 9065; 3632 
1; 1811; 5436; 5; 9070; 3634 
1; 1812; 5439; 5; 9075; 3636 
1; 1813; 5442; 5; 9080; 3638 
1; 1814; 5445; 5; 9085; 3640 
1; 1815; 5448; 5; 9090; 3642 
1; 1816; 5451; 5; 9095; 3644 
1; 1817; 5454; 5; 9100; 3646 
1; 1818; 5457; 5; 9105; 3648 
1; 1819; 5460; 5; 9110; 3650 
1; 1820; 5463; 5; 9115; 3652 
1; 1821; 5466; 5; 9120; 3654 
1; 1822; 5469; 5; 9125; 3656 
1; 1823; 5472; 5; 9130; 3658 
1; 1824; 5475; 5; 9135; 3660 
1; 1825; 5478; 5; 9140; 3662 
1; 1826; 5481; 5; 9145; 3664 
1; 1827; 5484; 5; 9150; 3666 
1; 1828; 5487; 5; 9155; 3668 
1; 1829; 5490; 5; 9160; 3670 
1; 1830; 5493; 5; 9165; 3672 
1; 1831; 5496; 5; 9170; 3674 
1; 1832; 5499; 5; 9175; 3676 
1; 1833; 5502; 5; 9180; 3678 
1; 1834; 5505; 5; 9185; 3680 
1; 1835; 5508; 5; 9190; 3682 
1; 1836; 5511; 5; 9195; 3684 
1; 1837; 5514; 5; 9200; 3686 
1; 1838; 5517; 5; 9205; 3688 
1; 1839; 5520; 5; 9210; 3690 
1; 1840; 5523; 5; 9215; 3692 
1; 1841; 5526; 5; 9220; 3694 
1; 1842; 5529; 5; 9225; 3696 
1; 1843; 5532; 5; 9230; 3698 
1; 1844; 5535; 5; 9235; 3700 
1; 1845; 5538; 5; 9240; 3702 
1; 1846; 5541; 5; 9245; 3704 
1; 1847; 5544; 5; 9250; 3706 
1; 1848; 5547; 5; 9255; 3708 
1; 1849; 5550; 5; 9260; 3710 
1; 1850; 5553; 5; 9265; 3712 
1; 1851; 5556; 5; 9270; 3714 
1; 1852; 5559; 5; 9275; 3716 
1; 1853; 5562; 5; 9280; 3718 
1; 1854; 5565; 5; 9285; 3720 
1; 1855; 5568; 5; 9290; 3722 
1; 1856; 5571; 5; 9295; 3724 
1; 1857; 5574; 5; 9300; 3726 
1; 1858; 5577; 5; 9305; 3728 
1; 1859; 5580; 5; 9310; 3730 
1; 1860; 5583; 5; 9315; 3732 
1; 1861; 5586; 5; 9320; 3734 
1; 1862; 5589; 5; 9325; 3736 
1; 1863; 5592; 5; 9330; 3738 
1; 1864; 5595; 5; 9335; 3740 
1; 1865; 5598; 5; 9340; 3742 
1; 1866; 5601; 5; 9345; 3744 
1; 1867; 5604; 5; 9350; 3746 
1; 1868; 5607; 5; 9355; 3748 
1; 1869; 5610; 5; 9360; 3750 
1; 1870; 5613; 5; 9365; 3752 
1; 1871; 5616; 5; 9370; 3754 
1; 1872; 5619; 5; 9375; 3756 
1; 1873; 5622; 5; 9380; 3758 
1; 1874; 5625; 5; 9385; 3760 
1; 1875; 5628; 5; 9390; 3762 
1; 1876; 5631; 5; 9395; 3764 
1; 1877; 5634; 5; 9400; 3766 
1; 1878; 5637; 5; 9405; 3768 
1; 1879; 5640; 5; 9410; 3770 
1; 1880; 5643; 5; 9415; 3772 
1; 1881; 5646; 5; 9420; 3774 
1; 1882; 5649; 5; 9425; 3776 
1; 1883; 5652; 5; 9430; 3778 
1; 1884; 5655; 5; 9435; 3780 
1; 1885; 5658; 5; 9440; 3782 
1; 1886; 5661; 5; 9445; 3784 
1; 1887; 5664; 5; 9450; 3786 
1; 1888; 5667; 5; 9455; 3788 
1; 1889; 5670; 5; 9460; 3790 
1; 1890; 5673; 5; 9465; 3792 
1; 1891; 5676; 5; 9470; 3794 
1; 1892; 5679; 5; 9475; 3796 
1; 1893; 5682; 5; 9480; 3798 
1; 1894; 5685; 5; 9485; 3800 
1; 1895; 5688; 5; 9490; 3802 
1; 1896; 5691; 5; 9495; 3804 
1; 1897; 5694; 5; 9500; 3806 
1; 1898; 5697; 5; 9505; 3808 
1; 1899; 5700; 5; 9510; 3810 
1; 1900; 5703; 5; 9515; 3812 
1; 1901; 5706; 5; 9520; 3814 
1; 1902; 5709; 5; 9525; 3816 
1; 1903; 5712; 5; 9530; 3818 
1; 1904; 5715; 5; 9535; 3820 
1; 1905; 5718; 5; 9540; 3822 
1; 1906; 5721; 5; 9545; 3824 
1; 1907; 5724; 5; 9550; 3826 
1; 1908; 5727; 5; 9555; 3828 
1; 1909; 5730; 5; 9560; 3830 
1; 1910; 5733; 5; 9565; 3832 
1; 1911; 5736; 5; 9570; 3834 
1; 1912; 5739; 5; 9575; 3836 
1; 1913; 5742; 5; 9580; 3838 
1; 1914; 5745; 5; 9585; 3840 
1; 1915; 5748; 5; 9590; 3842 
1; 1916; 5751; 5; 9595; 3844 
1; 1917; 5754; 5; 9600; 3846 
1; 1918; 5757; 5; 9605; 3848 
1; 1919; 5760; 5; 9610; 3850 
1; 1920; 5763; 5; 9615; 3852 
1; 1921; 5766; 5; 9620; 3854 
1; 1922; 5769; 5; 9625; 3856 
1; 1923; 5772; 5; 9630; 3858 
1; 1924; 5775; 5; 9635; 3860 
1; 1925; 5778; 5; 9640; 3862 
1; 1926; 5781; 5; 9645; 3864 
1; 1927; 5784; 5; 9650; 3866 
1; 1928; 5787; 5; 9655; 3868 
1; 1929; 5790; 5; 9660; 3870 
1; 1930; 5793; 5; 9665; 3872 
1; 1931; 5796; 5; 9670; 3874 
1; 1932; 5799; 5; 9675; 3876 
1; 1933; 5802; 5; 9680; 3878 
1; 1934; 5805; 5; 9685; 3880 
1; 1935; 5808; 5; 9690; 3882 
1; 1936; 5811; 5; 9695; 3884 
1; 1937; 5814; 5; 9700; 3886 
1; 1938; 5817; 5; 9705; 3888 
1; 1939; 5820; 5; 9710; 3890 
1; 1940; 5823; 5; 9715; 3892 
1; 1941; 5826; 5; 9720; 3894 
1; 1942; 5829; 5; 9725; 3896 
1; 1943; 5832; 5; 9730; 3898 
1; 1944; 5835; 5; 9735; 3900 
1; 1945; 5838; 5; 9740; 3902 
1; 1946; 5841; 5; 9745; 3904 
1; 1947; 5844; 5; 9750; 3906 
1; 1948; 5847; 5; 9755; 3908 
1; 1949; 5850; 5; 9760; 3910 
1; 1950; 5853; 5; 9765; 3912 
1; 1951; 5856; 5; 9770; 3914 
1; 1952; 5859; 5; 9775; 3916 
1; 1953; 5862; 5; 9780; 3918 
1; 1954; 5865; 5; 9785; 3920 
1; 1955; 5868; 5; 9790; 3922 
1; 1956; 5871; 5; 9795; 3924 
1; 1957; 5874; 5; 9800; 3926 
1; 1958; 5877; 5; 9805; 3928 
1; 1959; 5880; 5; 9810; 3930 
1; 1960; 5883; 5; 9815; 3932 
1; 1961; 5886; 5; 9820; 3934 
1; 1962; 5889; 5; 9825; 3936 
1; 1963; 5892; 5; 9830; 3938 
1; 1964; 5895; 5; 9835; 3940 
1; 1965; 5898; 5; 9840; 3942 
1; 1966; 5901; 5; 9845; 3944 
1; 1967; 5904; 5; 9850; 3946 
1; 1968; 5907; 5; 9855; 3948 
1; 1969; 5910; 5; 9860; 3950 
1; 1970; 5913; 5; 9865; 3952 
1; 1971; 5916; 5; 9870; 3954 
1; 1972; 5919; 5; 9875; 3956 
1; 1973; 5922; 5; 9880; 3958 
1; 1974; 5925; 5; 9885; 3960 
1; 1975; 5928; 5; 9890; 3962 
1; 1976; 5931; 5; 9895; 3964 
1; 1977; 5934; 5; 9900; 3966 
1; 1978; 5937; 5; 9905; 3968 
1; 1979; 5940; 5; 9910; 3970 
1; 1980; 5943; 5; 9915; 3972 
1; 1981; 5946; 5; 9920; 3974 
1; 1982; 5949; 5; 9925; 3976 
1; 1983; 5952; 5; 9930; 3978 
1; 1984; 5955; 5; 9935; 3980 
1; 1985; 5958; 5; 9940; 3982 
1; 1986; 5961; 5; 9945; 3984 
1; 1987; 5964; 5; 9950; 3986 
1; 1988; 5967; 5; 9955; 3988 
1; 1989; 5970; 5; 9960; 3990 
1; 1990; 5973; 5; 9965; 3992 
1; 1991; 5976; 5; 9970; 3994 
1; 1992; 5979; 5; 9975; 3996 
1; 1993; 5982; 5; 9980; 3998 
1; 1994; 5985; 5; 9985; 4000 
1; 1995; 5988; 5; 9990; 4002 
1; 1996; 5991; 5; 9995; 4004 
1; 1997; 5994; 5; 10000; 4006 
1; 1998; 5997; 5; 10005; 4008 
1; 1999; 6000; 5; 10010; 4010 
1; 2000; 6003; 5; 10015; 4012 
